Fecha,Region,Nuevos_casos,Casos_acumulados,Nuevos_recuperados,Recuperados_acumulados,Nuevas_muertes,Muertes_acumuladas,Activos
2023-01-01,Region_1,0,0,0,0,0,0,0
2023-01-02,Region_1,0,0,0,0,0,0,0
2023-01-03,Region_1,0,0,0,0,0,0,0
2023-01-04,Region_1,0,0,0,0,0,0,0
2023-01-05,Region_1,0,0,0,0,0,0,0
2023-01-06,Region_1,0,0,0,0,0,0,0
2023-01-07,Region_1,0,0,0,0,0,0,0
2023-01-08,Region_1,4,4,0,0,0,0,4
2023-01-09,Region_1,1,5,0,0,0,0,5
2023-01-10,Region_1,2,7,0,0,0,0,7
2023-01-11,Region_1,6,13,0,0,0,0,13
2023-01-12,Region_1,6,19,0,0,0,0,19
2023-01-13,Region_1,12,31,0,0,0,0,31
2023-01-14,Region_1,26,57,0,0,0,0,57
2023-01-15,Region_1,47,104,0,0,0,0,104
2023-01-16,Region_1,59,163,0,0,0,0,163
2023-01-17,Region_1,100,263,0,0,0,0,263
2023-01-18,Region_1,161,424,0,0,0,0,424
2023-01-19,Region_1,269,693,0,0,0,0,693
2023-01-20,Region_1,454,1147,0,0,0,0,1147
2023-01-21,Region_1,773,1920,0,0,0,0,1920
2023-01-22,Region_1,1215,3135,3,3,0,0,3131
2023-01-23,Region_1,2075,5210,0,4,0,0,5205
2023-01-24,Region_1,3390,8600,1,6,0,0,8593
2023-01-25,Region_1,5326,13926,5,12,0,0,13913
2023-01-26,Region_1,8510,22436,5,18,0,0,22417
2023-01-27,Region_1,13426,35862,11,29,0,0,35832
2023-01-28,Region_1,19726,55588,24,54,0,0,55532
2023-01-29,Region_1,27695,83283,44,98,0,1,83182
2023-01-30,Region_1,34835,118118,56,154,1,2,117960
2023-01-31,Region_1,36980,155098,95,249,1,4,154843
2023-02-01,Region_1,31445,186543,152,402,2,7,186132
2023-02-02,Region_1,20010,206553,255,658,4,12,205882
2023-02-03,Region_1,9626,216179,431,1089,7,19,215069
2023-02-04,Region_1,3761,219940,734,1823,13,33,218082
2023-02-05,Region_1,1282,221222,1154,2978,21,54,218189
2023-02-06,Region_1,494,221716,1971,4949,35,90,216676
2023-02-07,Region_1,157,221873,3220,8170,58,149,213553
2023-02-08,Region_1,48,221921,5059,13229,92,241,208449
2023-02-09,Region_1,26,221947,8084,21314,147,388,200243
2023-02-10,Region_1,5,221952,12754,34068,232,621,187261
2023-02-11,Region_1,5,221957,18739,52808,341,963,168184
2023-02-12,Region_1,1,221958,26310,79118,480,1443,141395
2023-02-13,Region_1,0,221958,33093,112212,603,2047,107698
2023-02-14,Region_1,0,221958,35131,147343,641,2688,71925
2023-02-15,Region_1,0,221958,29872,177215,545,3234,41507
2023-02-16,Region_1,0,221958,19009,196225,346,3581,22151
2023-02-17,Region_1,0,221958,9144,205370,166,3747,12839
2023-02-18,Region_1,0,221958,3572,208943,65,3813,9201
2023-02-19,Region_1,0,221958,1217,210160,22,3835,7961
2023-02-20,Region_1,0,221958,469,210630,8,3843,7483
2023-02-21,Region_1,0,221958,149,210779,2,3846,7331
2023-02-22,Region_1,0,221958,45,210824,0,3847,7285
2023-02-23,Region_1,0,221958,24,210849,0,3847,7260
2023-02-24,Region_1,0,221958,4,210854,0,3848,7255
2023-02-25,Region_1,0,221958,4,210859,0,3848,7250
2023-02-26,Region_1,0,221958,0,210860,0,3848,7249
2023-02-27,Region_1,0,221958,0,210860,0,3848,7249
2023-02-28,Region_1,0,221958,0,210860,0,3848,7249
2023-03-01,Region_1,0,221958,0,210860,0,3848,7249
2023-03-02,Region_1,0,221958,0,210860,0,3848,7249
2023-03-03,Region_1,0,221958,0,210860,0,3848,7249
2023-03-04,Region_1,0,221958,0,210860,0,3848,7249
2023-03-05,Region_1,0,221958,0,210860,0,3848,7249
2023-03-06,Region_1,0,221958,0,210860,0,3848,7249
2023-03-07,Region_1,0,221958,0,210860,0,3848,7249
2023-03-08,Region_1,0,221958,0,210860,0,3848,7249
2023-03-09,Region_1,0,221958,0,210860,0,3848,7249
2023-03-10,Region_1,0,221958,0,210860,0,3848,7249
2023-03-11,Region_1,0,221958,0,210860,0,3848,7249
2023-03-12,Region_1,0,221958,0,210860,0,3848,7249
2023-03-13,Region_1,0,221958,0,210860,0,3848,7249
2023-03-14,Region_1,0,221958,0,210860,0,3848,7249
2023-03-15,Region_1,0,221958,0,210860,0,3848,7249
2023-03-16,Region_1,0,221958,0,210860,0,3848,7249
2023-03-17,Region_1,0,221958,0,210860,0,3848,7249
2023-03-18,Region_1,0,221958,0,210860,0,3848,7249
2023-03-19,Region_1,0,221958,0,210860,0,3848,7249
2023-03-20,Region_1,0,221958,0,210860,0,3848,7249
2023-03-21,Region_1,0,221958,0,210860,0,3848,7249
2023-03-22,Region_1,0,221958,0,210860,0,3848,7249
2023-03-23,Region_1,0,221958,0,210860,0,3848,7249
2023-03-24,Region_1,0,221958,0,210860,0,3848,7249
2023-03-25,Region_1,0,221958,0,210860,0,3848,7249
2023-03-26,Region_1,0,221958,0,210860,0,3848,7249
2023-03-27,Region_1,0,221958,0,210860,0,3848,7249
2023-03-28,Region_1,0,221958,0,210860,0,3848,7249
2023-03-29,Region_1,0,221958,0,210860,0,3848,7249
2023-03-30,Region_1,0,221958,0,210860,0,3848,7249
2023-03-31,Region_1,0,221958,0,210860,0,3848,7249
2023-04-01,Region_1,0,221958,0,210860,0,3848,7249
2023-04-02,Region_1,0,221958,0,210860,0,3848,7249
2023-04-03,Region_1,0,221958,0,210860,0,3848,7249
2023-04-04,Region_1,0,221958,0,210860,0,3848,7249
2023-04-05,Region_1,0,221958,0,210860,0,3848,7249
2023-04-06,Region_1,0,221958,0,210860,0,3848,7249
2023-04-07,Region_1,0,221958,0,210860,0,3848,7249
2023-04-08,Region_1,0,221958,0,210860,0,3848,7249
2023-04-09,Region_1,0,221958,0,210860,0,3848,7249
2023-04-10,Region_1,0,221958,0,210860,0,3848,7249
2023-04-11,Region_1,0,221958,0,210860,0,3848,7249
2023-04-12,Region_1,0,221958,0,210860,0,3848,7249
2023-04-13,Region_1,0,221958,0,210860,0,3848,7249
2023-04-14,Region_1,0,221958,0,210860,0,3848,7249
2023-04-15,Region_1,0,221958,0,210860,0,3848,7249
2023-04-16,Region_1,0,221958,0,210860,0,3848,7249
2023-04-17,Region_1,0,221958,0,210860,0,3848,7249
2023-04-18,Region_1,0,221958,0,210860,0,3848,7249
2023-04-19,Region_1,0,221958,0,210860,0,3848,7249
2023-04-20,Region_1,0,221958,0,210860,0,3848,7249
2023-04-21,Region_1,0,221958,0,210860,0,3848,7249
2023-04-22,Region_1,0,221958,0,210860,0,3848,7249
2023-04-23,Region_1,0,221958,0,210860,0,3848,7249
2023-04-24,Region_1,0,221958,0,210860,0,3848,7249
2023-04-25,Region_1,0,221958,0,210860,0,3848,7249
2023-04-26,Region_1,0,221958,0,210860,0,3848,7249
2023-04-27,Region_1,0,221958,0,210860,0,3848,7249
2023-04-28,Region_1,0,221958,0,210860,0,3848,7249
2023-04-29,Region_1,0,221958,0,210860,0,3848,7249
2023-04-30,Region_1,0,221958,0,210860,0,3848,7249
2023-05-01,Region_1,0,221958,0,210860,0,3848,7249
2023-05-02,Region_1,0,221958,0,210860,0,3848,7249
2023-05-03,Region_1,0,221958,0,210860,0,3848,7249
2023-05-04,Region_1,0,221958,0,210860,0,3848,7249
2023-05-05,Region_1,0,221958,0,210860,0,3848,7249
2023-05-06,Region_1,0,221958,0,210860,0,3848,7249
2023-05-07,Region_1,0,221958,0,210860,0,3848,7249
2023-05-08,Region_1,0,221958,0,210860,0,3848,7249
2023-05-09,Region_1,0,221958,0,210860,0,3848,7249
2023-05-10,Region_1,0,221958,0,210860,0,3848,7249
2023-05-11,Region_1,0,221958,0,210860,0,3848,7249
2023-05-12,Region_1,0,221958,0,210860,0,3848,7249
2023-05-13,Region_1,0,221958,0,210860,0,3848,7249
2023-05-14,Region_1,0,221958,0,210860,0,3848,7249
2023-05-15,Region_1,0,221958,0,210860,0,3848,7249
2023-05-16,Region_1,0,221958,0,210860,0,3848,7249
2023-05-17,Region_1,0,221958,0,210860,0,3848,7249
2023-05-18,Region_1,0,221958,0,210860,0,3848,7249
2023-05-19,Region_1,0,221958,0,210860,0,3848,7249
2023-05-20,Region_1,0,221958,0,210860,0,3848,7249
2023-05-21,Region_1,0,221958,0,210860,0,3848,7249
2023-05-22,Region_1,0,221958,0,210860,0,3848,7249
2023-05-23,Region_1,0,221958,0,210860,0,3848,7249
2023-05-24,Region_1,0,221958,0,210860,0,3848,7249
2023-05-25,Region_1,0,221958,0,210860,0,3848,7249
2023-05-26,Region_1,0,221958,0,210860,0,3848,7249
2023-05-27,Region_1,0,221958,0,210860,0,3848,7249
2023-05-28,Region_1,0,221958,0,210860,0,3848,7249
2023-05-29,Region_1,0,221958,0,210860,0,3848,7249
2023-05-30,Region_1,0,221958,0,210860,0,3848,7249
2023-05-31,Region_1,0,221958,0,210860,0,3848,7249
2023-06-01,Region_1,0,221958,0,210860,0,3848,7249
2023-06-02,Region_1,0,221958,0,210860,0,3848,7249
2023-06-03,Region_1,0,221958,0,210860,0,3848,7249
2023-06-04,Region_1,0,221958,0,210860,0,3848,7249
2023-06-05,Region_1,0,221958,0,210860,0,3848,7249
2023-06-06,Region_1,0,221958,0,210860,0,3848,7249
2023-06-07,Region_1,0,221958,0,210860,0,3848,7249
2023-06-08,Region_1,0,221958,0,210860,0,3848,7249
2023-06-09,Region_1,0,221958,0,210860,0,3848,7249
2023-06-10,Region_1,0,221958,0,210860,0,3848,7249
2023-06-11,Region_1,0,221958,0,210860,0,3848,7249
2023-06-12,Region_1,0,221958,0,210860,0,3848,7249
2023-06-13,Region_1,0,221958,0,210860,0,3848,7249
2023-06-14,Region_1,0,221958,0,210860,0,3848,7249
2023-06-15,Region_1,0,221958,0,210860,0,3848,7249
2023-06-16,Region_1,0,221958,0,210860,0,3848,7249
2023-06-17,Region_1,0,221958,0,210860,0,3848,7249
2023-06-18,Region_1,0,221958,0,210860,0,3848,7249
2023-06-19,Region_1,0,221958,0,210860,0,3848,7249
2023-06-20,Region_1,0,221958,0,210860,0,3848,7249
2023-06-21,Region_1,0,221958,0,210860,0,3848,7249
2023-06-22,Region_1,0,221958,0,210860,0,3848,7249
2023-06-23,Region_1,0,221958,0,210860,0,3848,7249
2023-06-24,Region_1,0,221958,0,210860,0,3848,7249
2023-06-25,Region_1,0,221958,0,210860,0,3848,7249
2023-06-26,Region_1,0,221958,0,210860,0,3848,7249
2023-06-27,Region_1,0,221958,0,210860,0,3848,7249
2023-06-28,Region_1,0,221958,0,210860,0,3848,7249
2023-06-29,Region_1,0,221958,0,210860,0,3848,7249
2023-06-30,Region_1,0,221958,0,210860,0,3848,7249
2023-07-01,Region_1,0,221958,0,210860,0,3848,7249
2023-07-02,Region_1,0,221958,0,210860,0,3848,7249
2023-07-03,Region_1,0,221958,0,210860,0,3848,7249
2023-07-04,Region_1,0,221958,0,210860,0,3848,7249
2023-07-05,Region_1,0,221958,0,210860,0,3848,7249
2023-07-06,Region_1,0,221958,0,210860,0,3848,7249
2023-07-07,Region_1,0,221958,0,210860,0,3848,7249
2023-07-08,Region_1,0,221958,0,210860,0,3848,7249
2023-07-09,Region_1,0,221958,0,210860,0,3848,7249
2023-07-10,Region_1,0,221958,0,210860,0,3848,7249
2023-07-11,Region_1,0,221958,0,210860,0,3848,7249
2023-07-12,Region_1,0,221958,0,210860,0,3848,7249
2023-07-13,Region_1,0,221958,0,210860,0,3848,7249
2023-07-14,Region_1,0,221958,0,210860,0,3848,7249
2023-07-15,Region_1,0,221958,0,210860,0,3848,7249
2023-07-16,Region_1,0,221958,0,210860,0,3848,7249
2023-07-17,Region_1,0,221958,0,210860,0,3848,7249
2023-07-18,Region_1,0,221958,0,210860,0,3848,7249
2023-07-19,Region_1,0,221958,0,210860,0,3848,7249
2023-07-20,Region_1,0,221958,0,210860,0,3848,7249
2023-07-21,Region_1,0,221958,0,210860,0,3848,7249
2023-07-22,Region_1,0,221958,0,210860,0,3848,7249
2023-07-23,Region_1,0,221958,0,210860,0,3848,7249
2023-07-24,Region_1,0,221958,0,210860,0,3848,7249
2023-07-25,Region_1,0,221958,0,210860,0,3848,7249
2023-07-26,Region_1,0,221958,0,210860,0,3848,7249
2023-07-27,Region_1,0,221958,0,210860,0,3848,7249
2023-07-28,Region_1,0,221958,0,210860,0,3848,7249
2023-07-29,Region_1,0,221958,0,210860,0,3848,7249
2023-07-30,Region_1,0,221958,0,210860,0,3848,7249
2023-07-31,Region_1,0,221958,0,210860,0,3848,7249
2023-08-01,Region_1,0,221958,0,210860,0,3848,7249
2023-08-02,Region_1,0,221958,0,210860,0,3848,7249
2023-08-03,Region_1,0,221958,0,210860,0,3848,7249
2023-08-04,Region_1,0,221958,0,210860,0,3848,7249
2023-08-05,Region_1,0,221958,0,210860,0,3848,7249
2023-08-06,Region_1,0,221958,0,210860,0,3848,7249
2023-08-07,Region_1,0,221958,0,210860,0,3848,7249
2023-08-08,Region_1,0,221958,0,210860,0,3848,7249
2023-08-09,Region_1,0,221958,0,210860,0,3848,7249
2023-08-10,Region_1,0,221958,0,210860,0,3848,7249
2023-08-11,Region_1,0,221958,0,210860,0,3848,7249
2023-08-12,Region_1,0,221958,0,210860,0,3848,7249
2023-08-13,Region_1,0,221958,0,210860,0,3848,7249
2023-08-14,Region_1,0,221958,0,210860,0,3848,7249
2023-08-15,Region_1,0,221958,0,210860,0,3848,7249
2023-08-16,Region_1,0,221958,0,210860,0,3848,7249
2023-08-17,Region_1,0,221958,0,210860,0,3848,7249
2023-08-18,Region_1,0,221958,0,210860,0,3848,7249
2023-08-19,Region_1,0,221958,0,210860,0,3848,7249
2023-08-20,Region_1,0,221958,0,210860,0,3848,7249
2023-08-21,Region_1,0,221958,0,210860,0,3848,7249
2023-08-22,Region_1,0,221958,0,210860,0,3848,7249
2023-08-23,Region_1,0,221958,0,210860,0,3848,7249
2023-08-24,Region_1,0,221958,0,210860,0,3848,7249
2023-08-25,Region_1,0,221958,0,210860,0,3848,7249
2023-08-26,Region_1,0,221958,0,210860,0,3848,7249
2023-08-27,Region_1,0,221958,0,210860,0,3848,7249
2023-08-28,Region_1,0,221958,0,210860,0,3848,7249
2023-08-29,Region_1,0,221958,0,210860,0,3848,7249
2023-08-30,Region_1,0,221958,0,210860,0,3848,7249
2023-08-31,Region_1,0,221958,0,210860,0,3848,7249
2023-09-01,Region_1,0,221958,0,210860,0,3848,7249
2023-09-02,Region_1,0,221958,0,210860,0,3848,7249
2023-09-03,Region_1,0,221958,0,210860,0,3848,7249
2023-09-04,Region_1,0,221958,0,210860,0,3848,7249
2023-09-05,Region_1,0,221958,0,210860,0,3848,7249
2023-09-06,Region_1,0,221958,0,210860,0,3848,7249
2023-09-07,Region_1,0,221958,0,210860,0,3848,7249
2023-09-08,Region_1,0,221958,0,210860,0,3848,7249
2023-09-09,Region_1,0,221958,0,210860,0,3848,7249
2023-09-10,Region_1,0,221958,0,210860,0,3848,7249
2023-09-11,Region_1,0,221958,0,210860,0,3848,7249
2023-09-12,Region_1,0,221958,0,210860,0,3848,7249
2023-09-13,Region_1,0,221958,0,210860,0,3848,7249
2023-09-14,Region_1,0,221958,0,210860,0,3848,7249
2023-09-15,Region_1,0,221958,0,210860,0,3848,7249
2023-09-16,Region_1,0,221958,0,210860,0,3848,7249
2023-09-17,Region_1,0,221958,0,210860,0,3848,7249
2023-09-18,Region_1,0,221958,0,210860,0,3848,7249
2023-09-19,Region_1,0,221958,0,210860,0,3848,7249
2023-09-20,Region_1,0,221958,0,210860,0,3848,7249
2023-09-21,Region_1,0,221958,0,210860,0,3848,7249
2023-09-22,Region_1,0,221958,0,210860,0,3848,7249
2023-09-23,Region_1,0,221958,0,210860,0,3848,7249
2023-09-24,Region_1,0,221958,0,210860,0,3848,7249
2023-09-25,Region_1,0,221958,0,210860,0,3848,7249
2023-09-26,Region_1,0,221958,0,210860,0,3848,7249
2023-09-27,Region_1,0,221958,0,210860,0,3848,7249
2023-09-28,Region_1,0,221958,0,210860,0,3848,7249
2023-09-29,Region_1,0,221958,0,210860,0,3848,7249
2023-09-30,Region_1,0,221958,0,210860,0,3848,7249
2023-10-01,Region_1,0,221958,0,210860,0,3848,7249
2023-10-02,Region_1,0,221958,0,210860,0,3848,7249
2023-10-03,Region_1,0,221958,0,210860,0,3848,7249
2023-10-04,Region_1,0,221958,0,210860,0,3848,7249
2023-10-05,Region_1,0,221958,0,210860,0,3848,7249
2023-10-06,Region_1,0,221958,0,210860,0,3848,7249
2023-10-07,Region_1,0,221958,0,210860,0,3848,7249
2023-10-08,Region_1,0,221958,0,210860,0,3848,7249
2023-10-09,Region_1,0,221958,0,210860,0,3848,7249
2023-10-10,Region_1,0,221958,0,210860,0,3848,7249
2023-10-11,Region_1,0,221958,0,210860,0,3848,7249
2023-10-12,Region_1,0,221958,0,210860,0,3848,7249
2023-10-13,Region_1,0,221958,0,210860,0,3848,7249
2023-10-14,Region_1,0,221958,0,210860,0,3848,7249
2023-10-15,Region_1,0,221958,0,210860,0,3848,7249
2023-10-16,Region_1,0,221958,0,210860,0,3848,7249
2023-10-17,Region_1,0,221958,0,210860,0,3848,7249
2023-10-18,Region_1,0,221958,0,210860,0,3848,7249
2023-10-19,Region_1,0,221958,0,210860,0,3848,7249
2023-10-20,Region_1,0,221958,0,210860,0,3848,7249
2023-10-21,Region_1,0,221958,0,210860,0,3848,7249
2023-10-22,Region_1,0,221958,0,210860,0,3848,7249
2023-10-23,Region_1,0,221958,0,210860,0,3848,7249
2023-10-24,Region_1,0,221958,0,210860,0,3848,7249
2023-10-25,Region_1,0,221958,0,210860,0,3848,7249
2023-10-26,Region_1,0,221958,0,210860,0,3848,7249
2023-10-27,Region_1,0,221958,0,210860,0,3848,7249
2023-10-28,Region_1,0,221958,0,210860,0,3848,7249
2023-10-29,Region_1,0,221958,0,210860,0,3848,7249
2023-10-30,Region_1,0,221958,0,210860,0,3848,7249
2023-10-31,Region_1,0,221958,0,210860,0,3848,7249
2023-11-01,Region_1,0,221958,0,210860,0,3848,7249
2023-11-02,Region_1,0,221958,0,210860,0,3848,7249
2023-11-03,Region_1,0,221958,0,210860,0,3848,7249
2023-11-04,Region_1,0,221958,0,210860,0,3848,7249
2023-11-05,Region_1,0,221958,0,210860,0,3848,7249
2023-11-06,Region_1,0,221958,0,210860,0,3848,7249
2023-11-07,Region_1,0,221958,0,210860,0,3848,7249
2023-11-08,Region_1,0,221958,0,210860,0,3848,7249
2023-11-09,Region_1,0,221958,0,210860,0,3848,7249
2023-11-10,Region_1,0,221958,0,210860,0,3848,7249
2023-11-11,Region_1,0,221958,0,210860,0,3848,7249
2023-11-12,Region_1,0,221958,0,210860,0,3848,7249
2023-11-13,Region_1,0,221958,0,210860,0,3848,7249
2023-11-14,Region_1,0,221958,0,210860,0,3848,7249
2023-11-15,Region_1,0,221958,0,210860,0,3848,7249
2023-11-16,Region_1,0,221958,0,210860,0,3848,7249
2023-11-17,Region_1,0,221958,0,210860,0,3848,7249
2023-11-18,Region_1,0,221958,0,210860,0,3848,7249
2023-11-19,Region_1,0,221958,0,210860,0,3848,7249
2023-11-20,Region_1,0,221958,0,210860,0,3848,7249
2023-11-21,Region_1,0,221958,0,210860,0,3848,7249
2023-11-22,Region_1,0,221958,0,210860,0,3848,7249
2023-11-23,Region_1,0,221958,0,210860,0,3848,7249
2023-11-24,Region_1,0,221958,0,210860,0,3848,7249
2023-11-25,Region_1,0,221958,0,210860,0,3848,7249
2023-11-26,Region_1,0,221958,0,210860,0,3848,7249
2023-11-27,Region_1,0,221958,0,210860,0,3848,7249
2023-11-28,Region_1,0,221958,0,210860,0,3848,7249
2023-11-29,Region_1,0,221958,0,210860,0,3848,7249
2023-11-30,Region_1,0,221958,0,210860,0,3848,7249
2023-12-01,Region_1,0,221958,0,210860,0,3848,7249
2023-12-02,Region_1,0,221958,0,210860,0,3848,7249
2023-12-03,Region_1,0,221958,0,210860,0,3848,7249
2023-12-04,Region_1,0,221958,0,210860,0,3848,7249
2023-12-05,Region_1,0,221958,0,210860,0,3848,7249
2023-12-06,Region_1,0,221958,0,210860,0,3848,7249
2023-12-07,Region_1,0,221958,0,210860,0,3848,7249
2023-12-08,Region_1,0,221958,0,210860,0,3848,7249
2023-12-09,Region_1,0,221958,0,210860,0,3848,7249
2023-12-10,Region_1,0,221958,0,210860,0,3848,7249
2023-12-11,Region_1,0,221958,0,210860,0,3848,7249
2023-12-12,Region_1,0,221958,0,210860,0,3848,7249
2023-12-13,Region_1,0,221958,0,210860,0,3848,7249
2023-12-14,Region_1,0,221958,0,210860,0,3848,7249
2023-12-15,Region_1,0,221958,0,210860,0,3848,7249
2023-12-16,Region_1,0,221958,0,210860,0,3848,7249
2023-12-17,Region_1,0,221958,0,210860,0,3848,7249
2023-12-18,Region_1,0,221958,0,210860,0,3848,7249
2023-12-19,Region_1,0,221958,0,210860,0,3848,7249
2023-12-20,Region_1,0,221958,0,210860,0,3848,7249
2023-12-21,Region_1,0,221958,0,210860,0,3848,7249
2023-12-22,Region_1,0,221958,0,210860,0,3848,7249
2023-12-23,Region_1,0,221958,0,210860,0,3848,7249
2023-12-24,Region_1,0,221958,0,210860,0,3848,7249
2023-12-25,Region_1,0,221958,0,210860,0,3848,7249
2023-12-26,Region_1,0,221958,0,210860,0,3848,7249
2023-12-27,Region_1,0,221958,0,210860,0,3848,7249
2023-12-28,Region_1,0,221958,0,210860,0,3848,7249
2023-12-29,Region_1,0,221958,0,210860,0,3848,7249
2023-12-30,Region_1,0,221958,0,210860,0,3848,7249
2023-12-31,Region_1,0,221958,0,210860,0,3848,7249
2023-01-01,Region_2,0,0,0,0,0,0,0
2023-01-02,Region_2,0,0,0,0,0,0,0
2023-01-03,Region_2,0,0,0,0,0,0,0
2023-01-04,Region_2,1,1,0,0,0,0,1
2023-01-05,Region_2,0,1,0,0,0,0,1
2023-01-06,Region_2,0,1,0,0,0,0,1
2023-01-07,Region_2,0,1,0,0,0,0,1
2023-01-08,Region_2,0,1,0,0,0,0,1
2023-01-09,Region_2,0,1,0,0,0,0,1
2023-01-10,Region_2,0,1,0,0,0,0,1
2023-01-11,Region_2,0,1,0,0,0,0,1
2023-01-12,Region_2,0,1,0,0,0,0,1
2023-01-13,Region_2,0,1,0,0,0,0,1
2023-01-14,Region_2,0,1,0,0,0,0,1
2023-01-15,Region_2,0,1,0,0,0,0,1
2023-01-16,Region_2,0,1,0,0,0,0,1
2023-01-17,Region_2,0,1,0,0,0,0,1
2023-01-18,Region_2,0,1,0,0,0,0,1
2023-01-19,Region_2,0,1,0,0,0,0,1
2023-01-20,Region_2,0,1,0,0,0,0,1
2023-01-21,Region_2,0,1,0,0,0,0,0
2023-01-22,Region_2,0,1,0,0,0,0,0
2023-01-23,Region_2,0,1,0,0,0,0,0
2023-01-24,Region_2,0,1,0,0,0,0,0
2023-01-25,Region_2,0,1,0,0,0,0,0
2023-01-26,Region_2,0,1,0,0,0,0,0
2023-01-27,Region_2,0,1,0,0,0,0,0
2023-01-28,Region_2,0,1,0,0,0,0,0
2023-01-29,Region_2,0,1,0,0,0,0,0
2023-01-30,Region_2,0,1,0,0,0,0,0
2023-01-31,Region_2,0,1,0,0,0,0,0
2023-02-01,Region_2,0,1,0,0,0,0,0
2023-02-02,Region_2,0,1,0,0,0,0,0
2023-02-03,Region_2,0,1,0,0,0,0,0
2023-02-04,Region_2,0,1,0,0,0,0,0
2023-02-05,Region_2,0,1,0,0,0,0,0
2023-02-06,Region_2,0,1,0,0,0,0,0
2023-02-07,Region_2,0,1,0,0,0,0,0
2023-02-08,Region_2,0,1,0,0,0,0,0
2023-02-09,Region_2,0,1,0,0,0,0,0
2023-02-10,Region_2,0,1,0,0,0,0,0
2023-02-11,Region_2,0,1,0,0,0,0,0
2023-02-12,Region_2,0,1,0,0,0,0,0
2023-02-13,Region_2,0,1,0,0,0,0,0
2023-02-14,Region_2,0,1,0,0,0,0,0
2023-02-15,Region_2,0,1,0,0,0,0,0
2023-02-16,Region_2,0,1,0,0,0,0,0
2023-02-17,Region_2,0,1,0,0,0,0,0
2023-02-18,Region_2,0,1,0,0,0,0,0
2023-02-19,Region_2,0,1,0,0,0,0,0
2023-02-20,Region_2,0,1,0,0,0,0,0
2023-02-21,Region_2,0,1,0,0,0,0,0
2023-02-22,Region_2,0,1,0,0,0,0,0
2023-02-23,Region_2,0,1,0,0,0,0,0
2023-02-24,Region_2,0,1,0,0,0,0,0
2023-02-25,Region_2,0,1,0,0,0,0,0
2023-02-26,Region_2,0,1,0,0,0,0,0
2023-02-27,Region_2,0,1,0,0,0,0,0
2023-02-28,Region_2,0,1,0,0,0,0,0
2023-03-01,Region_2,0,1,0,0,0,0,0
2023-03-02,Region_2,0,1,0,0,0,0,0
2023-03-03,Region_2,0,1,0,0,0,0,0
2023-03-04,Region_2,0,1,0,0,0,0,0
2023-03-05,Region_2,0,1,0,0,0,0,0
2023-03-06,Region_2,0,1,0,0,0,0,0
2023-03-07,Region_2,0,1,0,0,0,0,0
2023-03-08,Region_2,0,1,0,0,0,0,0
2023-03-09,Region_2,0,1,0,0,0,0,0
2023-03-10,Region_2,0,1,0,0,0,0,0
2023-03-11,Region_2,0,1,0,0,0,0,0
2023-03-12,Region_2,0,1,0,0,0,0,0
2023-03-13,Region_2,0,1,0,0,0,0,0
2023-03-14,Region_2,0,1,0,0,0,0,0
2023-03-15,Region_2,0,1,0,0,0,0,0
2023-03-16,Region_2,0,1,0,0,0,0,0
2023-03-17,Region_2,0,1,0,0,0,0,0
2023-03-18,Region_2,0,1,0,0,0,0,0
2023-03-19,Region_2,0,1,0,0,0,0,0
2023-03-20,Region_2,0,1,0,0,0,0,0
2023-03-21,Region_2,0,1,0,0,0,0,0
2023-03-22,Region_2,0,1,0,0,0,0,0
2023-03-23,Region_2,0,1,0,0,0,0,0
2023-03-24,Region_2,0,1,0,0,0,0,0
2023-03-25,Region_2,0,1,0,0,0,0,0
2023-03-26,Region_2,0,1,0,0,0,0,0
2023-03-27,Region_2,0,1,0,0,0,0,0
2023-03-28,Region_2,0,1,0,0,0,0,0
2023-03-29,Region_2,0,1,0,0,0,0,0
2023-03-30,Region_2,0,1,0,0,0,0,0
2023-03-31,Region_2,0,1,0,0,0,0,0
2023-04-01,Region_2,0,1,0,0,0,0,0
2023-04-02,Region_2,0,1,0,0,0,0,0
2023-04-03,Region_2,0,1,0,0,0,0,0
2023-04-04,Region_2,0,1,0,0,0,0,0
2023-04-05,Region_2,0,1,0,0,0,0,0
2023-04-06,Region_2,0,1,0,0,0,0,0
2023-04-07,Region_2,0,1,0,0,0,0,0
2023-04-08,Region_2,0,1,0,0,0,0,0
2023-04-09,Region_2,0,1,0,0,0,0,0
2023-04-10,Region_2,0,1,0,0,0,0,0
2023-04-11,Region_2,0,1,0,0,0,0,0
2023-04-12,Region_2,0,1,0,0,0,0,0
2023-04-13,Region_2,0,1,0,0,0,0,0
2023-04-14,Region_2,0,1,0,0,0,0,0
2023-04-15,Region_2,0,1,0,0,0,0,0
2023-04-16,Region_2,0,1,0,0,0,0,0
2023-04-17,Region_2,0,1,0,0,0,0,0
2023-04-18,Region_2,0,1,0,0,0,0,0
2023-04-19,Region_2,0,1,0,0,0,0,0
2023-04-20,Region_2,0,1,0,0,0,0,0
2023-04-21,Region_2,0,1,0,0,0,0,0
2023-04-22,Region_2,0,1,0,0,0,0,0
2023-04-23,Region_2,0,1,0,0,0,0,0
2023-04-24,Region_2,0,1,0,0,0,0,0
2023-04-25,Region_2,0,1,0,0,0,0,0
2023-04-26,Region_2,0,1,0,0,0,0,0
2023-04-27,Region_2,0,1,0,0,0,0,0
2023-04-28,Region_2,0,1,0,0,0,0,0
2023-04-29,Region_2,0,1,0,0,0,0,0
2023-04-30,Region_2,0,1,0,0,0,0,0
2023-05-01,Region_2,0,1,0,0,0,0,0
2023-05-02,Region_2,0,1,0,0,0,0,0
2023-05-03,Region_2,0,1,0,0,0,0,0
2023-05-04,Region_2,0,1,0,0,0,0,0
2023-05-05,Region_2,0,1,0,0,0,0,0
2023-05-06,Region_2,0,1,0,0,0,0,0
2023-05-07,Region_2,0,1,0,0,0,0,0
2023-05-08,Region_2,0,1,0,0,0,0,0
2023-05-09,Region_2,0,1,0,0,0,0,0
2023-05-10,Region_2,0,1,0,0,0,0,0
2023-05-11,Region_2,0,1,0,0,0,0,0
2023-05-12,Region_2,0,1,0,0,0,0,0
2023-05-13,Region_2,0,1,0,0,0,0,0
2023-05-14,Region_2,0,1,0,0,0,0,0
2023-05-15,Region_2,0,1,0,0,0,0,0
2023-05-16,Region_2,0,1,0,0,0,0,0
2023-05-17,Region_2,0,1,0,0,0,0,0
2023-05-18,Region_2,0,1,0,0,0,0,0
2023-05-19,Region_2,0,1,0,0,0,0,0
2023-05-20,Region_2,0,1,0,0,0,0,0
2023-05-21,Region_2,0,1,0,0,0,0,0
2023-05-22,Region_2,0,1,0,0,0,0,0
2023-05-23,Region_2,0,1,0,0,0,0,0
2023-05-24,Region_2,0,1,0,0,0,0,0
2023-05-25,Region_2,0,1,0,0,0,0,0
2023-05-26,Region_2,0,1,0,0,0,0,0
2023-05-27,Region_2,0,1,0,0,0,0,0
2023-05-28,Region_2,0,1,0,0,0,0,0
2023-05-29,Region_2,0,1,0,0,0,0,0
2023-05-30,Region_2,0,1,0,0,0,0,0
2023-05-31,Region_2,0,1,0,0,0,0,0
2023-06-01,Region_2,0,1,0,0,0,0,0
2023-06-02,Region_2,0,1,0,0,0,0,0
2023-06-03,Region_2,0,1,0,0,0,0,0
2023-06-04,Region_2,0,1,0,0,0,0,0
2023-06-05,Region_2,0,1,0,0,0,0,0
2023-06-06,Region_2,0,1,0,0,0,0,0
2023-06-07,Region_2,0,1,0,0,0,0,0
2023-06-08,Region_2,0,1,0,0,0,0,0
2023-06-09,Region_2,0,1,0,0,0,0,0
2023-06-10,Region_2,0,1,0,0,0,0,0
2023-06-11,Region_2,0,1,0,0,0,0,0
2023-06-12,Region_2,0,1,0,0,0,0,0
2023-06-13,Region_2,0,1,0,0,0,0,0
2023-06-14,Region_2,0,1,0,0,0,0,0
2023-06-15,Region_2,0,1,0,0,0,0,0
2023-06-16,Region_2,0,1,0,0,0,0,0
2023-06-17,Region_2,0,1,0,0,0,0,0
2023-06-18,Region_2,0,1,0,0,0,0,0
2023-06-19,Region_2,0,1,0,0,0,0,0
2023-06-20,Region_2,0,1,0,0,0,0,0
2023-06-21,Region_2,0,1,0,0,0,0,0
2023-06-22,Region_2,0,1,0,0,0,0,0
2023-06-23,Region_2,0,1,0,0,0,0,0
2023-06-24,Region_2,0,1,0,0,0,0,0
2023-06-25,Region_2,0,1,0,0,0,0,0
2023-06-26,Region_2,0,1,0,0,0,0,0
2023-06-27,Region_2,0,1,0,0,0,0,0
2023-06-28,Region_2,0,1,0,0,0,0,0
2023-06-29,Region_2,0,1,0,0,0,0,0
2023-06-30,Region_2,0,1,0,0,0,0,0
2023-07-01,Region_2,0,1,0,0,0,0,0
2023-07-02,Region_2,0,1,0,0,0,0,0
2023-07-03,Region_2,0,1,0,0,0,0,0
2023-07-04,Region_2,0,1,0,0,0,0,0
2023-07-05,Region_2,0,1,0,0,0,0,0
2023-07-06,Region_2,0,1,0,0,0,0,0
2023-07-07,Region_2,0,1,0,0,0,0,0
2023-07-08,Region_2,0,1,0,0,0,0,0
2023-07-09,Region_2,0,1,0,0,0,0,0
2023-07-10,Region_2,0,1,0,0,0,0,0
2023-07-11,Region_2,0,1,0,0,0,0,0
2023-07-12,Region_2,0,1,0,0,0,0,0
2023-07-13,Region_2,0,1,0,0,0,0,0
2023-07-14,Region_2,0,1,0,0,0,0,0
2023-07-15,Region_2,0,1,0,0,0,0,0
2023-07-16,Region_2,0,1,0,0,0,0,0
2023-07-17,Region_2,0,1,0,0,0,0,0
2023-07-18,Region_2,0,1,0,0,0,0,0
2023-07-19,Region_2,0,1,0,0,0,0,0
2023-07-20,Region_2,0,1,0,0,0,0,0
2023-07-21,Region_2,0,1,0,0,0,0,0
2023-07-22,Region_2,0,1,0,0,0,0,0
2023-07-23,Region_2,0,1,0,0,0,0,0
2023-07-24,Region_2,0,1,0,0,0,0,0
2023-07-25,Region_2,0,1,0,0,0,0,0
2023-07-26,Region_2,0,1,0,0,0,0,0
2023-07-27,Region_2,0,1,0,0,0,0,0
2023-07-28,Region_2,0,1,0,0,0,0,0
2023-07-29,Region_2,0,1,0,0,0,0,0
2023-07-30,Region_2,0,1,0,0,0,0,0
2023-07-31,Region_2,0,1,0,0,0,0,0
2023-08-01,Region_2,0,1,0,0,0,0,0
2023-08-02,Region_2,0,1,0,0,0,0,0
2023-08-03,Region_2,0,1,0,0,0,0,0
2023-08-04,Region_2,0,1,0,0,0,0,0
2023-08-05,Region_2,0,1,0,0,0,0,0
2023-08-06,Region_2,0,1,0,0,0,0,0
2023-08-07,Region_2,0,1,0,0,0,0,0
2023-08-08,Region_2,0,1,0,0,0,0,0
2023-08-09,Region_2,0,1,0,0,0,0,0
2023-08-10,Region_2,0,1,0,0,0,0,0
2023-08-11,Region_2,0,1,0,0,0,0,0
2023-08-12,Region_2,0,1,0,0,0,0,0
2023-08-13,Region_2,0,1,0,0,0,0,0
2023-08-14,Region_2,0,1,0,0,0,0,0
2023-08-15,Region_2,0,1,0,0,0,0,0
2023-08-16,Region_2,0,1,0,0,0,0,0
2023-08-17,Region_2,0,1,0,0,0,0,0
2023-08-18,Region_2,0,1,0,0,0,0,0
2023-08-19,Region_2,0,1,0,0,0,0,0
2023-08-20,Region_2,0,1,0,0,0,0,0
2023-08-21,Region_2,0,1,0,0,0,0,0
2023-08-22,Region_2,0,1,0,0,0,0,0
2023-08-23,Region_2,0,1,0,0,0,0,0
2023-08-24,Region_2,0,1,0,0,0,0,0
2023-08-25,Region_2,0,1,0,0,0,0,0
2023-08-26,Region_2,0,1,0,0,0,0,0
2023-08-27,Region_2,0,1,0,0,0,0,0
2023-08-28,Region_2,0,1,0,0,0,0,0
2023-08-29,Region_2,0,1,0,0,0,0,0
2023-08-30,Region_2,0,1,0,0,0,0,0
2023-08-31,Region_2,0,1,0,0,0,0,0
2023-09-01,Region_2,0,1,0,0,0,0,0
2023-09-02,Region_2,0,1,0,0,0,0,0
2023-09-03,Region_2,0,1,0,0,0,0,0
2023-09-04,Region_2,0,1,0,0,0,0,0
2023-09-05,Region_2,0,1,0,0,0,0,0
2023-09-06,Region_2,0,1,0,0,0,0,0
2023-09-07,Region_2,0,1,0,0,0,0,0
2023-09-08,Region_2,0,1,0,0,0,0,0
2023-09-09,Region_2,0,1,0,0,0,0,0
2023-09-10,Region_2,0,1,0,0,0,0,0
2023-09-11,Region_2,0,1,0,0,0,0,0
2023-09-12,Region_2,0,1,0,0,0,0,0
2023-09-13,Region_2,0,1,0,0,0,0,0
2023-09-14,Region_2,0,1,0,0,0,0,0
2023-09-15,Region_2,0,1,0,0,0,0,0
2023-09-16,Region_2,0,1,0,0,0,0,0
2023-09-17,Region_2,0,1,0,0,0,0,0
2023-09-18,Region_2,0,1,0,0,0,0,0
2023-09-19,Region_2,0,1,0,0,0,0,0
2023-09-20,Region_2,0,1,0,0,0,0,0
2023-09-21,Region_2,0,1,0,0,0,0,0
2023-09-22,Region_2,0,1,0,0,0,0,0
2023-09-23,Region_2,0,1,0,0,0,0,0
2023-09-24,Region_2,0,1,0,0,0,0,0
2023-09-25,Region_2,0,1,0,0,0,0,0
2023-09-26,Region_2,0,1,0,0,0,0,0
2023-09-27,Region_2,0,1,0,0,0,0,0
2023-09-28,Region_2,0,1,0,0,0,0,0
2023-09-29,Region_2,0,1,0,0,0,0,0
2023-09-30,Region_2,0,1,0,0,0,0,0
2023-10-01,Region_2,0,1,0,0,0,0,0
2023-10-02,Region_2,0,1,0,0,0,0,0
2023-10-03,Region_2,0,1,0,0,0,0,0
2023-10-04,Region_2,0,1,0,0,0,0,0
2023-10-05,Region_2,0,1,0,0,0,0,0
2023-10-06,Region_2,0,1,0,0,0,0,0
2023-10-07,Region_2,0,1,0,0,0,0,0
2023-10-08,Region_2,0,1,0,0,0,0,0
2023-10-09,Region_2,0,1,0,0,0,0,0
2023-10-10,Region_2,0,1,0,0,0,0,0
2023-10-11,Region_2,0,1,0,0,0,0,0
2023-10-12,Region_2,0,1,0,0,0,0,0
2023-10-13,Region_2,0,1,0,0,0,0,0
2023-10-14,Region_2,0,1,0,0,0,0,0
2023-10-15,Region_2,0,1,0,0,0,0,0
2023-10-16,Region_2,0,1,0,0,0,0,0
2023-10-17,Region_2,0,1,0,0,0,0,0
2023-10-18,Region_2,0,1,0,0,0,0,0
2023-10-19,Region_2,0,1,0,0,0,0,0
2023-10-20,Region_2,0,1,0,0,0,0,0
2023-10-21,Region_2,0,1,0,0,0,0,0
2023-10-22,Region_2,0,1,0,0,0,0,0
2023-10-23,Region_2,0,1,0,0,0,0,0
2023-10-24,Region_2,0,1,0,0,0,0,0
2023-10-25,Region_2,0,1,0,0,0,0,0
2023-10-26,Region_2,0,1,0,0,0,0,0
2023-10-27,Region_2,0,1,0,0,0,0,0
2023-10-28,Region_2,0,1,0,0,0,0,0
2023-10-29,Region_2,0,1,0,0,0,0,0
2023-10-30,Region_2,0,1,0,0,0,0,0
2023-10-31,Region_2,0,1,0,0,0,0,0
2023-11-01,Region_2,0,1,0,0,0,0,0
2023-11-02,Region_2,0,1,0,0,0,0,0
2023-11-03,Region_2,0,1,0,0,0,0,0
2023-11-04,Region_2,0,1,0,0,0,0,0
2023-11-05,Region_2,0,1,0,0,0,0,0
2023-11-06,Region_2,0,1,0,0,0,0,0
2023-11-07,Region_2,0,1,0,0,0,0,0
2023-11-08,Region_2,0,1,0,0,0,0,0
2023-11-09,Region_2,0,1,0,0,0,0,0
2023-11-10,Region_2,0,1,0,0,0,0,0
2023-11-11,Region_2,0,1,0,0,0,0,0
2023-11-12,Region_2,0,1,0,0,0,0,0
2023-11-13,Region_2,0,1,0,0,0,0,0
2023-11-14,Region_2,0,1,0,0,0,0,0
2023-11-15,Region_2,0,1,0,0,0,0,0
2023-11-16,Region_2,0,1,0,0,0,0,0
2023-11-17,Region_2,0,1,0,0,0,0,0
2023-11-18,Region_2,0,1,0,0,0,0,0
2023-11-19,Region_2,0,1,0,0,0,0,0
2023-11-20,Region_2,0,1,0,0,0,0,0
2023-11-21,Region_2,0,1,0,0,0,0,0
2023-11-22,Region_2,0,1,0,0,0,0,0
2023-11-23,Region_2,0,1,0,0,0,0,0
2023-11-24,Region_2,0,1,0,0,0,0,0
2023-11-25,Region_2,0,1,0,0,0,0,0
2023-11-26,Region_2,0,1,0,0,0,0,0
2023-11-27,Region_2,0,1,0,0,0,0,0
2023-11-28,Region_2,0,1,0,0,0,0,0
2023-11-29,Region_2,0,1,0,0,0,0,0
2023-11-30,Region_2,0,1,0,0,0,0,0
2023-12-01,Region_2,0,1,0,0,0,0,0
2023-12-02,Region_2,0,1,0,0,0,0,0
2023-12-03,Region_2,0,1,0,0,0,0,0
2023-12-04,Region_2,0,1,0,0,0,0,0
2023-12-05,Region_2,0,1,0,0,0,0,0
2023-12-06,Region_2,0,1,0,0,0,0,0
2023-12-07,Region_2,0,1,0,0,0,0,0
2023-12-08,Region_2,0,1,0,0,0,0,0
2023-12-09,Region_2,0,1,0,0,0,0,0
2023-12-10,Region_2,0,1,0,0,0,0,0
2023-12-11,Region_2,0,1,0,0,0,0,0
2023-12-12,Region_2,0,1,0,0,0,0,0
2023-12-13,Region_2,0,1,0,0,0,0,0
2023-12-14,Region_2,0,1,0,0,0,0,0
2023-12-15,Region_2,0,1,0,0,0,0,0
2023-12-16,Region_2,0,1,0,0,0,0,0
2023-12-17,Region_2,0,1,0,0,0,0,0
2023-12-18,Region_2,0,1,0,0,0,0,0
2023-12-19,Region_2,0,1,0,0,0,0,0
2023-12-20,Region_2,0,1,0,0,0,0,0
2023-12-21,Region_2,0,1,0,0,0,0,0
2023-12-22,Region_2,0,1,0,0,0,0,0
2023-12-23,Region_2,0,1,0,0,0,0,0
2023-12-24,Region_2,0,1,0,0,0,0,0
2023-12-25,Region_2,0,1,0,0,0,0,0
2023-12-26,Region_2,0,1,0,0,0,0,0
2023-12-27,Region_2,0,1,0,0,0,0,0
2023-12-28,Region_2,0,1,0,0,0,0,0
2023-12-29,Region_2,0,1,0,0,0,0,0
2023-12-30,Region_2,0,1,0,0,0,0,0
2023-12-31,Region_2,0,1,0,0,0,0,0
2023-01-01,Region_3,0,0,0,0,0,0,0
2023-01-02,Region_3,0,0,0,0,0,0,0
2023-01-03,Region_3,0,0,0,0,0,0,0
2023-01-04,Region_3,0,0,0,0,0,0,0
2023-01-05,Region_3,0,0,0,0,0,0,0
2023-01-06,Region_3,0,0,0,0,0,0,0
2023-01-07,Region_3,0,0,0,0,0,0,0
2023-01-08,Region_3,0,0,0,0,0,0,0
2023-01-09,Region_3,0,0,0,0,0,0,0
2023-01-10,Region_3,0,0,0,0,0,0,0
2023-01-11,Region_3,0,0,0,0,0,0,0
2023-01-12,Region_3,0,0,0,0,0,0,0
2023-01-13,Region_3,0,0,0,0,0,0,0
2023-01-14,Region_3,0,0,0,0,0,0,0
2023-01-15,Region_3,0,0,0,0,0,0,0
2023-01-16,Region_3,0,0,0,0,0,0,0
2023-01-17,Region_3,0,0,0,0,0,0,0
2023-01-18,Region_3,0,0,0,0,0,0,0
2023-01-19,Region_3,0,0,0,0,0,0,0
2023-01-20,Region_3,0,0,0,0,0,0,0
2023-01-21,Region_3,0,0,0,0,0,0,0
2023-01-22,Region_3,0,0,0,0,0,0,0
2023-01-23,Region_3,0,0,0,0,0,0,0
2023-01-24,Region_3,0,0,0,0,0,0,0
2023-01-25,Region_3,0,0,0,0,0,0,0
2023-01-26,Region_3,0,0,0,0,0,0,0
2023-01-27,Region_3,0,0,0,0,0,0,0
2023-01-28,Region_3,0,0,0,0,0,0,0
2023-01-29,Region_3,0,0,0,0,0,0,0
2023-01-30,Region_3,4,4,0,0,0,0,4
2023-01-31,Region_3,3,7,0,0,0,0,7
2023-02-01,Region_3,2,9,0,0,0,0,9
2023-02-02,Region_3,0,9,0,0,0,0,9
2023-02-03,Region_3,2,11,0,0,0,0,11
2023-02-04,Region_3,3,14,0,0,0,0,14
2023-02-05,Region_3,7,21,0,0,0,0,21
2023-02-06,Region_3,7,28,0,0,0,0,28
2023-02-07,Region_3,8,36,0,0,0,0,36
2023-02-08,Region_3,20,56,0,0,0,0,56
2023-02-09,Region_3,18,74,0,0,0,0,74
2023-02-10,Region_3,35,109,0,0,0,0,109
2023-02-11,Region_3,34,143,0,0,0,0,143
2023-02-12,Region_3,58,201,0,0,0,0,201
2023-02-13,Region_3,72,273,0,0,0,0,273
2023-02-14,Region_3,81,354,3,3,0,0,350
2023-02-15,Region_3,140,494,2,6,0,0,487
2023-02-16,Region_3,165,659,1,8,0,0,650
2023-02-17,Region_3,241,900,0,8,0,0,891
2023-02-18,Region_3,342,1242,1,10,0,0,1231
2023-02-19,Region_3,447,1689,2,13,0,0,1675
2023-02-20,Region_3,568,2257,6,19,0,0,2236
2023-02-21,Region_3,804,3061,6,26,0,1,3033
2023-02-22,Region_3,1030,4091,7,34,0,1,4055
2023-02-23,Region_3,1445,5536,19,53,0,2,5480
2023-02-24,Region_3,1962,7498,17,70,0,2,7424
2023-02-25,Region_3,2652,10150,33,103,1,4,10042
2023-02-26,Region_3,3497,13647,32,135,1,5,13505
2023-02-27,Region_3,4738,18385,55,190,2,7,18186
2023-02-28,Region_3,6311,24696,68,259,2,10,24426
2023-03-01,Region_3,8171,32867,76,336,3,13,32516
2023-03-02,Region_3,10779,43646,133,469,5,19,43157
2023-03-03,Region_3,14199,57845,156,626,6,25,57193
2023-03-04,Region_3,18042,75887,228,855,9,34,74997
2023-03-05,Region_3,22393,98280,324,1179,13,48,97051
2023-03-06,Region_3,26951,125231,424,1604,17,65,123560
2023-03-07,Region_3,31596,156827,539,2144,22,87,154595
2023-03-08,Region_3,35616,192443,763,2907,31,119,189416
2023-03-09,Region_3,38143,230586,978,3886,40,159,226540
2023-03-10,Region_3,37839,268425,1372,5259,56,215,262950
2023-03-11,Region_3,35367,303792,1863,7123,76,291,296377
2023-03-12,Region_3,31259,335051,2519,9642,103,394,325013
2023-03-13,Region_3,25220,360271,3322,12964,135,530,346775
2023-03-14,Region_3,19913,380184,4501,17465,184,714,362003
2023-03-15,Region_3,14395,394579,5995,23461,245,960,370157
2023-03-16,Region_3,10207,404786,7762,31223,317,1277,372284
2023-03-17,Region_3,6909,411695,10240,41463,419,1696,368534
2023-03-18,Region_3,4865,416560,13489,54952,552,2249,359358
2023-03-19,Region_3,3193,419753,17139,72092,701,2950,344709
2023-03-20,Region_3,2049,421802,21273,93366,870,3821,324614
2023-03-21,Region_3,1357,423159,25603,118969,1047,4868,299320
2023-03-22,Region_3,816,423975,30016,148985,1228,6097,268891
2023-03-23,Region_3,373,424348,33835,182820,1384,7482,234044
2023-03-24,Region_3,38,424386,36235,219056,1482,8965,196364
2023-03-25,Region_3,0,424386,35947,255003,1471,10436,158945
2023-03-26,Region_3,0,424386,33598,288602,1375,11811,123972
2023-03-27,Region_3,0,424386,29696,318298,1215,13026,93060
2023-03-28,Region_3,0,424386,23959,342257,980,14007,68121
2023-03-29,Region_3,0,424386,18917,361174,774,14781,48429
2023-03-30,Region_3,0,424386,13675,374850,559,15341,34194
2023-03-31,Region_3,0,424386,9696,384546,396,15738,24101
2023-04-01,Region_3,0,424386,6563,391110,268,16006,17269
2023-04-02,Region_3,0,424386,4621,395731,189,16195,12458
2023-04-03,Region_3,0,424386,3033,398765,124,16319,9300
2023-04-04,Region_3,0,424386,1946,400711,79,16399,7274
2023-04-05,Region_3,0,424386,1289,402001,52,16452,5932
2023-04-06,Region_3,0,424386,775,402776,31,16484,5125
2023-04-07,Region_3,0,424386,354,403130,14,16498,4756
2023-04-08,Region_3,0,424386,36,403166,1,16500,4719
2023-04-09,Region_3,0,424386,0,403166,0,16500,4719
2023-04-10,Region_3,0,424386,0,403166,0,16500,4719
2023-04-11,Region_3,0,424386,0,403166,0,16500,4719
2023-04-12,Region_3,0,424386,0,403166,0,16500,4719
2023-04-13,Region_3,0,424386,0,403166,0,16500,4719
2023-04-14,Region_3,0,424386,0,403166,0,16500,4719
2023-04-15,Region_3,0,424386,0,403166,0,16500,4719
2023-04-16,Region_3,0,424386,0,403166,0,16500,4719
2023-04-17,Region_3,0,424386,0,403166,0,16500,4719
2023-04-18,Region_3,0,424386,0,403166,0,16500,4719
2023-04-19,Region_3,0,424386,0,403166,0,16500,4719
2023-04-20,Region_3,0,424386,0,403166,0,16500,4719
2023-04-21,Region_3,0,424386,0,403166,0,16500,4719
2023-04-22,Region_3,0,424386,0,403166,0,16500,4719
2023-04-23,Region_3,0,424386,0,403166,0,16500,4719
2023-04-24,Region_3,0,424386,0,403166,0,16500,4719
2023-04-25,Region_3,0,424386,0,403166,0,16500,4719
2023-04-26,Region_3,0,424386,0,403166,0,16500,4719
2023-04-27,Region_3,0,424386,0,403166,0,16500,4719
2023-04-28,Region_3,0,424386,0,403166,0,16500,4719
2023-04-29,Region_3,0,424386,0,403166,0,16500,4719
2023-04-30,Region_3,0,424386,0,403166,0,16500,4719
2023-05-01,Region_3,0,424386,0,403166,0,16500,4719
2023-05-02,Region_3,0,424386,0,403166,0,16500,4719
2023-05-03,Region_3,0,424386,0,403166,0,16500,4719
2023-05-04,Region_3,0,424386,0,403166,0,16500,4719
2023-05-05,Region_3,0,424386,0,403166,0,16500,4719
2023-05-06,Region_3,0,424386,0,403166,0,16500,4719
2023-05-07,Region_3,0,424386,0,403166,0,16500,4719
2023-05-08,Region_3,0,424386,0,403166,0,16500,4719
2023-05-09,Region_3,0,424386,0,403166,0,16500,4719
2023-05-10,Region_3,0,424386,0,403166,0,16500,4719
2023-05-11,Region_3,0,424386,0,403166,0,16500,4719
2023-05-12,Region_3,0,424386,0,403166,0,16500,4719
2023-05-13,Region_3,0,424386,0,403166,0,16500,4719
2023-05-14,Region_3,0,424386,0,403166,0,16500,4719
2023-05-15,Region_3,0,424386,0,403166,0,16500,4719
2023-05-16,Region_3,0,424386,0,403166,0,16500,4719
2023-05-17,Region_3,0,424386,0,403166,0,16500,4719
2023-05-18,Region_3,0,424386,0,403166,0,16500,4719
2023-05-19,Region_3,0,424386,0,403166,0,16500,4719
2023-05-20,Region_3,0,424386,0,403166,0,16500,4719
2023-05-21,Region_3,0,424386,0,403166,0,16500,4719
2023-05-22,Region_3,0,424386,0,403166,0,16500,4719
2023-05-23,Region_3,0,424386,0,403166,0,16500,4719
2023-05-24,Region_3,0,424386,0,403166,0,16500,4719
2023-05-25,Region_3,0,424386,0,403166,0,16500,4719
2023-05-26,Region_3,0,424386,0,403166,0,16500,4719
2023-05-27,Region_3,0,424386,0,403166,0,16500,4719
2023-05-28,Region_3,0,424386,0,403166,0,16500,4719
2023-05-29,Region_3,0,424386,0,403166,0,16500,4719
2023-05-30,Region_3,0,424386,0,403166,0,16500,4719
2023-05-31,Region_3,0,424386,0,403166,0,16500,4719
2023-06-01,Region_3,0,424386,0,403166,0,16500,4719
2023-06-02,Region_3,0,424386,0,403166,0,16500,4719
2023-06-03,Region_3,0,424386,0,403166,0,16500,4719
2023-06-04,Region_3,0,424386,0,403166,0,16500,4719
2023-06-05,Region_3,0,424386,0,403166,0,16500,4719
2023-06-06,Region_3,0,424386,0,403166,0,16500,4719
2023-06-07,Region_3,0,424386,0,403166,0,16500,4719
2023-06-08,Region_3,0,424386,0,403166,0,16500,4719
2023-06-09,Region_3,0,424386,0,403166,0,16500,4719
2023-06-10,Region_3,0,424386,0,403166,0,16500,4719
2023-06-11,Region_3,0,424386,0,403166,0,16500,4719
2023-06-12,Region_3,0,424386,0,403166,0,16500,4719
2023-06-13,Region_3,0,424386,0,403166,0,16500,4719
2023-06-14,Region_3,0,424386,0,403166,0,16500,4719
2023-06-15,Region_3,0,424386,0,403166,0,16500,4719
2023-06-16,Region_3,0,424386,0,403166,0,16500,4719
2023-06-17,Region_3,0,424386,0,403166,0,16500,4719
2023-06-18,Region_3,0,424386,0,403166,0,16500,4719
2023-06-19,Region_3,0,424386,0,403166,0,16500,4719
2023-06-20,Region_3,0,424386,0,403166,0,16500,4719
2023-06-21,Region_3,0,424386,0,403166,0,16500,4719
2023-06-22,Region_3,0,424386,0,403166,0,16500,4719
2023-06-23,Region_3,0,424386,0,403166,0,16500,4719
2023-06-24,Region_3,0,424386,0,403166,0,16500,4719
2023-06-25,Region_3,0,424386,0,403166,0,16500,4719
2023-06-26,Region_3,0,424386,0,403166,0,16500,4719
2023-06-27,Region_3,0,424386,0,403166,0,16500,4719
2023-06-28,Region_3,0,424386,0,403166,0,16500,4719
2023-06-29,Region_3,0,424386,0,403166,0,16500,4719
2023-06-30,Region_3,0,424386,0,403166,0,16500,4719
2023-07-01,Region_3,0,424386,0,403166,0,16500,4719
2023-07-02,Region_3,0,424386,0,403166,0,16500,4719
2023-07-03,Region_3,0,424386,0,403166,0,16500,4719
2023-07-04,Region_3,0,424386,0,403166,0,16500,4719
2023-07-05,Region_3,0,424386,0,403166,0,16500,4719
2023-07-06,Region_3,0,424386,0,403166,0,16500,4719
2023-07-07,Region_3,0,424386,0,403166,0,16500,4719
2023-07-08,Region_3,0,424386,0,403166,0,16500,4719
2023-07-09,Region_3,0,424386,0,403166,0,16500,4719
2023-07-10,Region_3,0,424386,0,403166,0,16500,4719
2023-07-11,Region_3,0,424386,0,403166,0,16500,4719
2023-07-12,Region_3,0,424386,0,403166,0,16500,4719
2023-07-13,Region_3,0,424386,0,403166,0,16500,4719
2023-07-14,Region_3,0,424386,0,403166,0,16500,4719
2023-07-15,Region_3,0,424386,0,403166,0,16500,4719
2023-07-16,Region_3,0,424386,0,403166,0,16500,4719
2023-07-17,Region_3,0,424386,0,403166,0,16500,4719
2023-07-18,Region_3,0,424386,0,403166,0,16500,4719
2023-07-19,Region_3,0,424386,0,403166,0,16500,4719
2023-07-20,Region_3,0,424386,0,403166,0,16500,4719
2023-07-21,Region_3,0,424386,0,403166,0,16500,4719
2023-07-22,Region_3,0,424386,0,403166,0,16500,4719
2023-07-23,Region_3,0,424386,0,403166,0,16500,4719
2023-07-24,Region_3,0,424386,0,403166,0,16500,4719
2023-07-25,Region_3,0,424386,0,403166,0,16500,4719
2023-07-26,Region_3,0,424386,0,403166,0,16500,4719
2023-07-27,Region_3,0,424386,0,403166,0,16500,4719
2023-07-28,Region_3,0,424386,0,403166,0,16500,4719
2023-07-29,Region_3,0,424386,0,403166,0,16500,4719
2023-07-30,Region_3,0,424386,0,403166,0,16500,4719
2023-07-31,Region_3,0,424386,0,403166,0,16500,4719
2023-08-01,Region_3,0,424386,0,403166,0,16500,4719
2023-08-02,Region_3,0,424386,0,403166,0,16500,4719
2023-08-03,Region_3,0,424386,0,403166,0,16500,4719
2023-08-04,Region_3,0,424386,0,403166,0,16500,4719
2023-08-05,Region_3,0,424386,0,403166,0,16500,4719
2023-08-06,Region_3,0,424386,0,403166,0,16500,4719
2023-08-07,Region_3,0,424386,0,403166,0,16500,4719
2023-08-08,Region_3,0,424386,0,403166,0,16500,4719
2023-08-09,Region_3,0,424386,0,403166,0,16500,4719
2023-08-10,Region_3,0,424386,0,403166,0,16500,4719
2023-08-11,Region_3,0,424386,0,403166,0,16500,4719
2023-08-12,Region_3,0,424386,0,403166,0,16500,4719
2023-08-13,Region_3,0,424386,0,403166,0,16500,4719
2023-08-14,Region_3,0,424386,0,403166,0,16500,4719
2023-08-15,Region_3,0,424386,0,403166,0,16500,4719
2023-08-16,Region_3,0,424386,0,403166,0,16500,4719
2023-08-17,Region_3,0,424386,0,403166,0,16500,4719
2023-08-18,Region_3,0,424386,0,403166,0,16500,4719
2023-08-19,Region_3,0,424386,0,403166,0,16500,4719
2023-08-20,Region_3,0,424386,0,403166,0,16500,4719
2023-08-21,Region_3,0,424386,0,403166,0,16500,4719
2023-08-22,Region_3,0,424386,0,403166,0,16500,4719
2023-08-23,Region_3,0,424386,0,403166,0,16500,4719
2023-08-24,Region_3,0,424386,0,403166,0,16500,4719
2023-08-25,Region_3,0,424386,0,403166,0,16500,4719
2023-08-26,Region_3,0,424386,0,403166,0,16500,4719
2023-08-27,Region_3,0,424386,0,403166,0,16500,4719
2023-08-28,Region_3,0,424386,0,403166,0,16500,4719
2023-08-29,Region_3,0,424386,0,403166,0,16500,4719
2023-08-30,Region_3,0,424386,0,403166,0,16500,4719
2023-08-31,Region_3,0,424386,0,403166,0,16500,4719
2023-09-01,Region_3,0,424386,0,403166,0,16500,4719
2023-09-02,Region_3,0,424386,0,403166,0,16500,4719
2023-09-03,Region_3,0,424386,0,403166,0,16500,4719
2023-09-04,Region_3,0,424386,0,403166,0,16500,4719
2023-09-05,Region_3,0,424386,0,403166,0,16500,4719
2023-09-06,Region_3,0,424386,0,403166,0,16500,4719
2023-09-07,Region_3,0,424386,0,403166,0,16500,4719
2023-09-08,Region_3,0,424386,0,403166,0,16500,4719
2023-09-09,Region_3,0,424386,0,403166,0,16500,4719
2023-09-10,Region_3,0,424386,0,403166,0,16500,4719
2023-09-11,Region_3,0,424386,0,403166,0,16500,4719
2023-09-12,Region_3,0,424386,0,403166,0,16500,4719
2023-09-13,Region_3,0,424386,0,403166,0,16500,4719
2023-09-14,Region_3,0,424386,0,403166,0,16500,4719
2023-09-15,Region_3,0,424386,0,403166,0,16500,4719
2023-09-16,Region_3,0,424386,0,403166,0,16500,4719
2023-09-17,Region_3,0,424386,0,403166,0,16500,4719
2023-09-18,Region_3,0,424386,0,403166,0,16500,4719
2023-09-19,Region_3,0,424386,0,403166,0,16500,4719
2023-09-20,Region_3,0,424386,0,403166,0,16500,4719
2023-09-21,Region_3,0,424386,0,403166,0,16500,4719
2023-09-22,Region_3,0,424386,0,403166,0,16500,4719
2023-09-23,Region_3,0,424386,0,403166,0,16500,4719
2023-09-24,Region_3,0,424386,0,403166,0,16500,4719
2023-09-25,Region_3,0,424386,0,403166,0,16500,4719
2023-09-26,Region_3,0,424386,0,403166,0,16500,4719
2023-09-27,Region_3,0,424386,0,403166,0,16500,4719
2023-09-28,Region_3,0,424386,0,403166,0,16500,4719
2023-09-29,Region_3,0,424386,0,403166,0,16500,4719
2023-09-30,Region_3,0,424386,0,403166,0,16500,4719
2023-10-01,Region_3,0,424386,0,403166,0,16500,4719
2023-10-02,Region_3,0,424386,0,403166,0,16500,4719
2023-10-03,Region_3,0,424386,0,403166,0,16500,4719
2023-10-04,Region_3,0,424386,0,403166,0,16500,4719
2023-10-05,Region_3,0,424386,0,403166,0,16500,4719
2023-10-06,Region_3,0,424386,0,403166,0,16500,4719
2023-10-07,Region_3,0,424386,0,403166,0,16500,4719
2023-10-08,Region_3,0,424386,0,403166,0,16500,4719
2023-10-09,Region_3,0,424386,0,403166,0,16500,4719
2023-10-10,Region_3,0,424386,0,403166,0,16500,4719
2023-10-11,Region_3,0,424386,0,403166,0,16500,4719
2023-10-12,Region_3,0,424386,0,403166,0,16500,4719
2023-10-13,Region_3,0,424386,0,403166,0,16500,4719
2023-10-14,Region_3,0,424386,0,403166,0,16500,4719
2023-10-15,Region_3,0,424386,0,403166,0,16500,4719
2023-10-16,Region_3,0,424386,0,403166,0,16500,4719
2023-10-17,Region_3,0,424386,0,403166,0,16500,4719
2023-10-18,Region_3,0,424386,0,403166,0,16500,4719
2023-10-19,Region_3,0,424386,0,403166,0,16500,4719
2023-10-20,Region_3,0,424386,0,403166,0,16500,4719
2023-10-21,Region_3,0,424386,0,403166,0,16500,4719
2023-10-22,Region_3,0,424386,0,403166,0,16500,4719
2023-10-23,Region_3,0,424386,0,403166,0,16500,4719
2023-10-24,Region_3,0,424386,0,403166,0,16500,4719
2023-10-25,Region_3,0,424386,0,403166,0,16500,4719
2023-10-26,Region_3,0,424386,0,403166,0,16500,4719
2023-10-27,Region_3,0,424386,0,403166,0,16500,4719
2023-10-28,Region_3,0,424386,0,403166,0,16500,4719
2023-10-29,Region_3,0,424386,0,403166,0,16500,4719
2023-10-30,Region_3,0,424386,0,403166,0,16500,4719
2023-10-31,Region_3,0,424386,0,403166,0,16500,4719
2023-11-01,Region_3,0,424386,0,403166,0,16500,4719
2023-11-02,Region_3,0,424386,0,403166,0,16500,4719
2023-11-03,Region_3,0,424386,0,403166,0,16500,4719
2023-11-04,Region_3,0,424386,0,403166,0,16500,4719
2023-11-05,Region_3,0,424386,0,403166,0,16500,4719
2023-11-06,Region_3,0,424386,0,403166,0,16500,4719
2023-11-07,Region_3,0,424386,0,403166,0,16500,4719
2023-11-08,Region_3,0,424386,0,403166,0,16500,4719
2023-11-09,Region_3,0,424386,0,403166,0,16500,4719
2023-11-10,Region_3,0,424386,0,403166,0,16500,4719
2023-11-11,Region_3,0,424386,0,403166,0,16500,4719
2023-11-12,Region_3,0,424386,0,403166,0,16500,4719
2023-11-13,Region_3,0,424386,0,403166,0,16500,4719
2023-11-14,Region_3,0,424386,0,403166,0,16500,4719
2023-11-15,Region_3,0,424386,0,403166,0,16500,4719
2023-11-16,Region_3,0,424386,0,403166,0,16500,4719
2023-11-17,Region_3,0,424386,0,403166,0,16500,4719
2023-11-18,Region_3,0,424386,0,403166,0,16500,4719
2023-11-19,Region_3,0,424386,0,403166,0,16500,4719
2023-11-20,Region_3,0,424386,0,403166,0,16500,4719
2023-11-21,Region_3,0,424386,0,403166,0,16500,4719
2023-11-22,Region_3,0,424386,0,403166,0,16500,4719
2023-11-23,Region_3,0,424386,0,403166,0,16500,4719
2023-11-24,Region_3,0,424386,0,403166,0,16500,4719
2023-11-25,Region_3,0,424386,0,403166,0,16500,4719
2023-11-26,Region_3,0,424386,0,403166,0,16500,4719
2023-11-27,Region_3,0,424386,0,403166,0,16500,4719
2023-11-28,Region_3,0,424386,0,403166,0,16500,4719
2023-11-29,Region_3,0,424386,0,403166,0,16500,4719
2023-11-30,Region_3,0,424386,0,403166,0,16500,4719
2023-12-01,Region_3,0,424386,0,403166,0,16500,4719
2023-12-02,Region_3,0,424386,0,403166,0,16500,4719
2023-12-03,Region_3,0,424386,0,403166,0,16500,4719
2023-12-04,Region_3,0,424386,0,403166,0,16500,4719
2023-12-05,Region_3,0,424386,0,403166,0,16500,4719
2023-12-06,Region_3,0,424386,0,403166,0,16500,4719
2023-12-07,Region_3,0,424386,0,403166,0,16500,4719
2023-12-08,Region_3,0,424386,0,403166,0,16500,4719
2023-12-09,Region_3,0,424386,0,403166,0,16500,4719
2023-12-10,Region_3,0,424386,0,403166,0,16500,4719
2023-12-11,Region_3,0,424386,0,403166,0,16500,4719
2023-12-12,Region_3,0,424386,0,403166,0,16500,4719
2023-12-13,Region_3,0,424386,0,403166,0,16500,4719
2023-12-14,Region_3,0,424386,0,403166,0,16500,4719
2023-12-15,Region_3,0,424386,0,403166,0,16500,4719
2023-12-16,Region_3,0,424386,0,403166,0,16500,4719
2023-12-17,Region_3,0,424386,0,403166,0,16500,4719
2023-12-18,Region_3,0,424386,0,403166,0,16500,4719
2023-12-19,Region_3,0,424386,0,403166,0,16500,4719
2023-12-20,Region_3,0,424386,0,403166,0,16500,4719
2023-12-21,Region_3,0,424386,0,403166,0,16500,4719
2023-12-22,Region_3,0,424386,0,403166,0,16500,4719
2023-12-23,Region_3,0,424386,0,403166,0,16500,4719
2023-12-24,Region_3,0,424386,0,403166,0,16500,4719
2023-12-25,Region_3,0,424386,0,403166,0,16500,4719
2023-12-26,Region_3,0,424386,0,403166,0,16500,4719
2023-12-27,Region_3,0,424386,0,403166,0,16500,4719
2023-12-28,Region_3,0,424386,0,403166,0,16500,4719
2023-12-29,Region_3,0,424386,0,403166,0,16500,4719
2023-12-30,Region_3,0,424386,0,403166,0,16500,4719
2023-12-31,Region_3,0,424386,0,403166,0,16500,4719
2023-01-01,Region_4,0,0,0,0,0,0,0
2023-01-02,Region_4,0,0,0,0,0,0,0
2023-01-03,Region_4,0,0,0,0,0,0,0
2023-01-04,Region_4,0,0,0,0,0,0,0
2023-01-05,Region_4,0,0,0,0,0,0,0
2023-01-06,Region_4,0,0,0,0,0,0,0
2023-01-07,Region_4,0,0,0,0,0,0,0
2023-01-08,Region_4,0,0,0,0,0,0,0
2023-01-09,Region_4,0,0,0,0,0,0,0
2023-01-10,Region_4,0,0,0,0,0,0,0
2023-01-11,Region_4,0,0,0,0,0,0,0
2023-01-12,Region_4,0,0,0,0,0,0,0
2023-01-13,Region_4,0,0,0,0,0,0,0
2023-01-14,Region_4,0,0,0,0,0,0,0
2023-01-15,Region_4,0,0,0,0,0,0,0
2023-01-16,Region_4,0,0,0,0,0,0,0
2023-01-17,Region_4,0,0,0,0,0,0,0
2023-01-18,Region_4,0,0,0,0,0,0,0
2023-01-19,Region_4,0,0,0,0,0,0,0
2023-01-20,Region_4,0,0,0,0,0,0,0
2023-01-21,Region_4,0,0,0,0,0,0,0
2023-01-22,Region_4,3,3,0,0,0,0,3
2023-01-23,Region_4,1,4,0,0,0,0,4
2023-01-24,Region_4,0,4,0,0,0,0,4
2023-01-25,Region_4,1,5,0,0,0,0,5
2023-01-26,Region_4,2,7,0,0,0,0,7
2023-01-27,Region_4,1,8,0,0,0,0,8
2023-01-28,Region_4,0,8,0,0,0,0,8
2023-01-29,Region_4,2,10,0,0,0,0,10
2023-01-30,Region_4,4,14,0,0,0,0,14
2023-01-31,Region_4,7,21,0,0,0,0,21
2023-02-01,Region_4,4,25,0,0,0,0,25
2023-02-02,Region_4,12,37,0,0,0,0,37
2023-02-03,Region_4,11,48,0,0,0,0,48
2023-02-04,Region_4,16,64,0,0,0,0,64
2023-02-05,Region_4,30,94,0,0,0,0,94
2023-02-06,Region_4,42,136,0,0,0,0,136
2023-02-07,Region_4,57,193,0,0,0,0,193
2023-02-08,Region_4,71,264,0,0,0,0,264
2023-02-09,Region_4,116,380,2,2,0,0,377
2023-02-10,Region_4,137,517,0,3,0,0,513
2023-02-11,Region_4,219,736,0,3,0,0,732
2023-02-12,Region_4,275,1011,0,4,0,0,1006
2023-02-13,Region_4,414,1425,1,6,0,0,1418
2023-02-14,Region_4,582,2007,0,7,0,0,1999
2023-02-15,Region_4,835,2842,0,7,0,0,2834
2023-02-16,Region_4,1087,3929,1,9,0,0,3919
2023-02-17,Region_4,1625,5554,3,13,0,0,5540
2023-02-18,Region_4,2321,7875,6,19,0,0,7854
2023-02-19,Region_4,3116,10991,3,23,0,0,10966
2023-02-20,Region_4,4401,15392,11,35,0,0,15356
2023-02-21,Region_4,6012,21404,10,45,0,1,21357
2023-02-22,Region_4,8101,29505,15,60,0,1,29442
2023-02-23,Region_4,10707,40212,28,89,0,2,40120
2023-02-24,Region_4,13668,53880,39,129,0,3,53747
2023-02-25,Region_4,16741,70621,54,183,1,4,70433
2023-02-26,Region_4,19763,90384,67,250,1,5,90127
2023-02-27,Region_4,21029,111413,110,361,2,8,111043
2023-02-28,Region_4,21435,132848,130,491,3,11,132345
2023-03-01,Region_4,19428,152276,208,699,4,16,151560
2023-03-02,Region_4,16061,168337,261,960,6,22,167354
2023-03-03,Region_4,12243,180580,393,1353,9,31,179194
2023-03-04,Region_4,8550,189130,552,1906,12,44,187178
2023-03-05,Region_4,5513,194643,793,2699,18,63,191880
2023-03-06,Region_4,3306,197949,1032,3732,24,87,194129
2023-03-07,Region_4,2056,200005,1543,5276,36,123,194605
2023-03-08,Region_4,1273,201278,2204,7481,51,174,193622
2023-03-09,Region_4,781,202059,2960,10441,69,243,191373
2023-03-10,Region_4,416,202475,4180,14622,97,341,187511
2023-03-11,Region_4,265,202740,5711,20333,133,474,181931
2023-03-12,Region_4,166,202906,7695,28029,179,654,174222
2023-03-13,Region_4,91,202997,10171,38201,237,891,163904
2023-03-14,Region_4,50,203047,12984,51186,303,1194,150666
2023-03-15,Region_4,6,203053,15903,67089,371,1565,134397
2023-03-16,Region_4,0,203053,18774,85864,438,2003,115184
2023-03-17,Region_4,0,203053,19977,105842,466,2469,94740
2023-03-18,Region_4,0,203053,20363,126205,475,2945,73902
2023-03-19,Region_4,0,203053,18456,144662,430,3375,55014
2023-03-20,Region_4,0,203053,15257,159920,356,3731,39400
2023-03-21,Region_4,0,203053,11630,171551,271,4003,27498
2023-03-22,Region_4,0,203053,8122,179673,189,4192,19186
2023-03-23,Region_4,0,203053,5237,184910,122,4315,13826
2023-03-24,Region_4,0,203053,3140,188051,73,4388,10612
2023-03-25,Region_4,0,203053,1953,190004,45,4434,8614
2023-03-26,Region_4,0,203053,1209,191214,28,4462,7376
2023-03-27,Region_4,0,203053,741,191956,17,4479,6617
2023-03-28,Region_4,0,203053,395,192351,9,4488,6212
2023-03-29,Region_4,0,203053,251,192603,5,4494,5955
2023-03-30,Region_4,0,203053,157,192760,3,4498,5793
2023-03-31,Region_4,0,203053,86,192847,2,4500,5705
2023-04-01,Region_4,0,203053,47,192894,1,4501,5656
2023-04-02,Region_4,0,203053,5,192900,0,4501,5651
2023-04-03,Region_4,0,203053,0,192900,0,4501,5651
2023-04-04,Region_4,0,203053,0,192900,0,4501,5651
2023-04-05,Region_4,0,203053,0,192900,0,4501,5651
2023-04-06,Region_4,0,203053,0,192900,0,4501,5651
2023-04-07,Region_4,0,203053,0,192900,0,4501,5651
2023-04-08,Region_4,0,203053,0,192900,0,4501,5651
2023-04-09,Region_4,0,203053,0,192900,0,4501,5651
2023-04-10,Region_4,0,203053,0,192900,0,4501,5651
2023-04-11,Region_4,0,203053,0,192900,0,4501,5651
2023-04-12,Region_4,0,203053,0,192900,0,4501,5651
2023-04-13,Region_4,0,203053,0,192900,0,4501,5651
2023-04-14,Region_4,0,203053,0,192900,0,4501,5651
2023-04-15,Region_4,0,203053,0,192900,0,4501,5651
2023-04-16,Region_4,0,203053,0,192900,0,4501,5651
2023-04-17,Region_4,0,203053,0,192900,0,4501,5651
2023-04-18,Region_4,0,203053,0,192900,0,4501,5651
2023-04-19,Region_4,0,203053,0,192900,0,4501,5651
2023-04-20,Region_4,0,203053,0,192900,0,4501,5651
2023-04-21,Region_4,0,203053,0,192900,0,4501,5651
2023-04-22,Region_4,0,203053,0,192900,0,4501,5651
2023-04-23,Region_4,0,203053,0,192900,0,4501,5651
2023-04-24,Region_4,0,203053,0,192900,0,4501,5651
2023-04-25,Region_4,0,203053,0,192900,0,4501,5651
2023-04-26,Region_4,0,203053,0,192900,0,4501,5651
2023-04-27,Region_4,0,203053,0,192900,0,4501,5651
2023-04-28,Region_4,0,203053,0,192900,0,4501,5651
2023-04-29,Region_4,0,203053,0,192900,0,4501,5651
2023-04-30,Region_4,0,203053,0,192900,0,4501,5651
2023-05-01,Region_4,0,203053,0,192900,0,4501,5651
2023-05-02,Region_4,0,203053,0,192900,0,4501,5651
2023-05-03,Region_4,0,203053,0,192900,0,4501,5651
2023-05-04,Region_4,0,203053,0,192900,0,4501,5651
2023-05-05,Region_4,0,203053,0,192900,0,4501,5651
2023-05-06,Region_4,0,203053,0,192900,0,4501,5651
2023-05-07,Region_4,0,203053,0,192900,0,4501,5651
2023-05-08,Region_4,0,203053,0,192900,0,4501,5651
2023-05-09,Region_4,0,203053,0,192900,0,4501,5651
2023-05-10,Region_4,0,203053,0,192900,0,4501,5651
2023-05-11,Region_4,0,203053,0,192900,0,4501,5651
2023-05-12,Region_4,0,203053,0,192900,0,4501,5651
2023-05-13,Region_4,0,203053,0,192900,0,4501,5651
2023-05-14,Region_4,0,203053,0,192900,0,4501,5651
2023-05-15,Region_4,0,203053,0,192900,0,4501,5651
2023-05-16,Region_4,0,203053,0,192900,0,4501,5651
2023-05-17,Region_4,0,203053,0,192900,0,4501,5651
2023-05-18,Region_4,0,203053,0,192900,0,4501,5651
2023-05-19,Region_4,0,203053,0,192900,0,4501,5651
2023-05-20,Region_4,0,203053,0,192900,0,4501,5651
2023-05-21,Region_4,0,203053,0,192900,0,4501,5651
2023-05-22,Region_4,0,203053,0,192900,0,4501,5651
2023-05-23,Region_4,0,203053,0,192900,0,4501,5651
2023-05-24,Region_4,0,203053,0,192900,0,4501,5651
2023-05-25,Region_4,0,203053,0,192900,0,4501,5651
2023-05-26,Region_4,0,203053,0,192900,0,4501,5651
2023-05-27,Region_4,0,203053,0,192900,0,4501,5651
2023-05-28,Region_4,0,203053,0,192900,0,4501,5651
2023-05-29,Region_4,0,203053,0,192900,0,4501,5651
2023-05-30,Region_4,0,203053,0,192900,0,4501,5651
2023-05-31,Region_4,0,203053,0,192900,0,4501,5651
2023-06-01,Region_4,0,203053,0,192900,0,4501,5651
2023-06-02,Region_4,0,203053,0,192900,0,4501,5651
2023-06-03,Region_4,0,203053,0,192900,0,4501,5651
2023-06-04,Region_4,0,203053,0,192900,0,4501,5651
2023-06-05,Region_4,0,203053,0,192900,0,4501,5651
2023-06-06,Region_4,0,203053,0,192900,0,4501,5651
2023-06-07,Region_4,0,203053,0,192900,0,4501,5651
2023-06-08,Region_4,0,203053,0,192900,0,4501,5651
2023-06-09,Region_4,0,203053,0,192900,0,4501,5651
2023-06-10,Region_4,0,203053,0,192900,0,4501,5651
2023-06-11,Region_4,0,203053,0,192900,0,4501,5651
2023-06-12,Region_4,0,203053,0,192900,0,4501,5651
2023-06-13,Region_4,0,203053,0,192900,0,4501,5651
2023-06-14,Region_4,0,203053,0,192900,0,4501,5651
2023-06-15,Region_4,0,203053,0,192900,0,4501,5651
2023-06-16,Region_4,0,203053,0,192900,0,4501,5651
2023-06-17,Region_4,0,203053,0,192900,0,4501,5651
2023-06-18,Region_4,0,203053,0,192900,0,4501,5651
2023-06-19,Region_4,0,203053,0,192900,0,4501,5651
2023-06-20,Region_4,0,203053,0,192900,0,4501,5651
2023-06-21,Region_4,0,203053,0,192900,0,4501,5651
2023-06-22,Region_4,0,203053,0,192900,0,4501,5651
2023-06-23,Region_4,0,203053,0,192900,0,4501,5651
2023-06-24,Region_4,0,203053,0,192900,0,4501,5651
2023-06-25,Region_4,0,203053,0,192900,0,4501,5651
2023-06-26,Region_4,0,203053,0,192900,0,4501,5651
2023-06-27,Region_4,0,203053,0,192900,0,4501,5651
2023-06-28,Region_4,0,203053,0,192900,0,4501,5651
2023-06-29,Region_4,0,203053,0,192900,0,4501,5651
2023-06-30,Region_4,0,203053,0,192900,0,4501,5651
2023-07-01,Region_4,0,203053,0,192900,0,4501,5651
2023-07-02,Region_4,0,203053,0,192900,0,4501,5651
2023-07-03,Region_4,0,203053,0,192900,0,4501,5651
2023-07-04,Region_4,0,203053,0,192900,0,4501,5651
2023-07-05,Region_4,0,203053,0,192900,0,4501,5651
2023-07-06,Region_4,0,203053,0,192900,0,4501,5651
2023-07-07,Region_4,0,203053,0,192900,0,4501,5651
2023-07-08,Region_4,0,203053,0,192900,0,4501,5651
2023-07-09,Region_4,0,203053,0,192900,0,4501,5651
2023-07-10,Region_4,0,203053,0,192900,0,4501,5651
2023-07-11,Region_4,0,203053,0,192900,0,4501,5651
2023-07-12,Region_4,0,203053,0,192900,0,4501,5651
2023-07-13,Region_4,0,203053,0,192900,0,4501,5651
2023-07-14,Region_4,0,203053,0,192900,0,4501,5651
2023-07-15,Region_4,0,203053,0,192900,0,4501,5651
2023-07-16,Region_4,0,203053,0,192900,0,4501,5651
2023-07-17,Region_4,0,203053,0,192900,0,4501,5651
2023-07-18,Region_4,0,203053,0,192900,0,4501,5651
2023-07-19,Region_4,0,203053,0,192900,0,4501,5651
2023-07-20,Region_4,0,203053,0,192900,0,4501,5651
2023-07-21,Region_4,0,203053,0,192900,0,4501,5651
2023-07-22,Region_4,0,203053,0,192900,0,4501,5651
2023-07-23,Region_4,0,203053,0,192900,0,4501,5651
2023-07-24,Region_4,0,203053,0,192900,0,4501,5651
2023-07-25,Region_4,0,203053,0,192900,0,4501,5651
2023-07-26,Region_4,0,203053,0,192900,0,4501,5651
2023-07-27,Region_4,0,203053,0,192900,0,4501,5651
2023-07-28,Region_4,0,203053,0,192900,0,4501,5651
2023-07-29,Region_4,0,203053,0,192900,0,4501,5651
2023-07-30,Region_4,0,203053,0,192900,0,4501,5651
2023-07-31,Region_4,0,203053,0,192900,0,4501,5651
2023-08-01,Region_4,0,203053,0,192900,0,4501,5651
2023-08-02,Region_4,0,203053,0,192900,0,4501,5651
2023-08-03,Region_4,0,203053,0,192900,0,4501,5651
2023-08-04,Region_4,0,203053,0,192900,0,4501,5651
2023-08-05,Region_4,0,203053,0,192900,0,4501,5651
2023-08-06,Region_4,0,203053,0,192900,0,4501,5651
2023-08-07,Region_4,0,203053,0,192900,0,4501,5651
2023-08-08,Region_4,0,203053,0,192900,0,4501,5651
2023-08-09,Region_4,0,203053,0,192900,0,4501,5651
2023-08-10,Region_4,0,203053,0,192900,0,4501,5651
2023-08-11,Region_4,0,203053,0,192900,0,4501,5651
2023-08-12,Region_4,0,203053,0,192900,0,4501,5651
2023-08-13,Region_4,0,203053,0,192900,0,4501,5651
2023-08-14,Region_4,0,203053,0,192900,0,4501,5651
2023-08-15,Region_4,0,203053,0,192900,0,4501,5651
2023-08-16,Region_4,0,203053,0,192900,0,4501,5651
2023-08-17,Region_4,0,203053,0,192900,0,4501,5651
2023-08-18,Region_4,0,203053,0,192900,0,4501,5651
2023-08-19,Region_4,0,203053,0,192900,0,4501,5651
2023-08-20,Region_4,0,203053,0,192900,0,4501,5651
2023-08-21,Region_4,0,203053,0,192900,0,4501,5651
2023-08-22,Region_4,0,203053,0,192900,0,4501,5651
2023-08-23,Region_4,0,203053,0,192900,0,4501,5651
2023-08-24,Region_4,0,203053,0,192900,0,4501,5651
2023-08-25,Region_4,0,203053,0,192900,0,4501,5651
2023-08-26,Region_4,0,203053,0,192900,0,4501,5651
2023-08-27,Region_4,0,203053,0,192900,0,4501,5651
2023-08-28,Region_4,0,203053,0,192900,0,4501,5651
2023-08-29,Region_4,0,203053,0,192900,0,4501,5651
2023-08-30,Region_4,0,203053,0,192900,0,4501,5651
2023-08-31,Region_4,0,203053,0,192900,0,4501,5651
2023-09-01,Region_4,0,203053,0,192900,0,4501,5651
2023-09-02,Region_4,0,203053,0,192900,0,4501,5651
2023-09-03,Region_4,0,203053,0,192900,0,4501,5651
2023-09-04,Region_4,0,203053,0,192900,0,4501,5651
2023-09-05,Region_4,0,203053,0,192900,0,4501,5651
2023-09-06,Region_4,0,203053,0,192900,0,4501,5651
2023-09-07,Region_4,0,203053,0,192900,0,4501,5651
2023-09-08,Region_4,0,203053,0,192900,0,4501,5651
2023-09-09,Region_4,0,203053,0,192900,0,4501,5651
2023-09-10,Region_4,0,203053,0,192900,0,4501,5651
2023-09-11,Region_4,0,203053,0,192900,0,4501,5651
2023-09-12,Region_4,0,203053,0,192900,0,4501,5651
2023-09-13,Region_4,0,203053,0,192900,0,4501,5651
2023-09-14,Region_4,0,203053,0,192900,0,4501,5651
2023-09-15,Region_4,0,203053,0,192900,0,4501,5651
2023-09-16,Region_4,0,203053,0,192900,0,4501,5651
2023-09-17,Region_4,0,203053,0,192900,0,4501,5651
2023-09-18,Region_4,0,203053,0,192900,0,4501,5651
2023-09-19,Region_4,0,203053,0,192900,0,4501,5651
2023-09-20,Region_4,0,203053,0,192900,0,4501,5651
2023-09-21,Region_4,0,203053,0,192900,0,4501,5651
2023-09-22,Region_4,0,203053,0,192900,0,4501,5651
2023-09-23,Region_4,0,203053,0,192900,0,4501,5651
2023-09-24,Region_4,0,203053,0,192900,0,4501,5651
2023-09-25,Region_4,0,203053,0,192900,0,4501,5651
2023-09-26,Region_4,0,203053,0,192900,0,4501,5651
2023-09-27,Region_4,0,203053,0,192900,0,4501,5651
2023-09-28,Region_4,0,203053,0,192900,0,4501,5651
2023-09-29,Region_4,0,203053,0,192900,0,4501,5651
2023-09-30,Region_4,0,203053,0,192900,0,4501,5651
2023-10-01,Region_4,0,203053,0,192900,0,4501,5651
2023-10-02,Region_4,0,203053,0,192900,0,4501,5651
2023-10-03,Region_4,0,203053,0,192900,0,4501,5651
2023-10-04,Region_4,0,203053,0,192900,0,4501,5651
2023-10-05,Region_4,0,203053,0,192900,0,4501,5651
2023-10-06,Region_4,0,203053,0,192900,0,4501,5651
2023-10-07,Region_4,0,203053,0,192900,0,4501,5651
2023-10-08,Region_4,0,203053,0,192900,0,4501,5651
2023-10-09,Region_4,0,203053,0,192900,0,4501,5651
2023-10-10,Region_4,0,203053,0,192900,0,4501,5651
2023-10-11,Region_4,0,203053,0,192900,0,4501,5651
2023-10-12,Region_4,0,203053,0,192900,0,4501,5651
2023-10-13,Region_4,0,203053,0,192900,0,4501,5651
2023-10-14,Region_4,0,203053,0,192900,0,4501,5651
2023-10-15,Region_4,0,203053,0,192900,0,4501,5651
2023-10-16,Region_4,0,203053,0,192900,0,4501,5651
2023-10-17,Region_4,0,203053,0,192900,0,4501,5651
2023-10-18,Region_4,0,203053,0,192900,0,4501,5651
2023-10-19,Region_4,0,203053,0,192900,0,4501,5651
2023-10-20,Region_4,0,203053,0,192900,0,4501,5651
2023-10-21,Region_4,0,203053,0,192900,0,4501,5651
2023-10-22,Region_4,0,203053,0,192900,0,4501,5651
2023-10-23,Region_4,0,203053,0,192900,0,4501,5651
2023-10-24,Region_4,0,203053,0,192900,0,4501,5651
2023-10-25,Region_4,0,203053,0,192900,0,4501,5651
2023-10-26,Region_4,0,203053,0,192900,0,4501,5651
2023-10-27,Region_4,0,203053,0,192900,0,4501,5651
2023-10-28,Region_4,0,203053,0,192900,0,4501,5651
2023-10-29,Region_4,0,203053,0,192900,0,4501,5651
2023-10-30,Region_4,0,203053,0,192900,0,4501,5651
2023-10-31,Region_4,0,203053,0,192900,0,4501,5651
2023-11-01,Region_4,0,203053,0,192900,0,4501,5651
2023-11-02,Region_4,0,203053,0,192900,0,4501,5651
2023-11-03,Region_4,0,203053,0,192900,0,4501,5651
2023-11-04,Region_4,0,203053,0,192900,0,4501,5651
2023-11-05,Region_4,0,203053,0,192900,0,4501,5651
2023-11-06,Region_4,0,203053,0,192900,0,4501,5651
2023-11-07,Region_4,0,203053,0,192900,0,4501,5651
2023-11-08,Region_4,0,203053,0,192900,0,4501,5651
2023-11-09,Region_4,0,203053,0,192900,0,4501,5651
2023-11-10,Region_4,0,203053,0,192900,0,4501,5651
2023-11-11,Region_4,0,203053,0,192900,0,4501,5651
2023-11-12,Region_4,0,203053,0,192900,0,4501,5651
2023-11-13,Region_4,0,203053,0,192900,0,4501,5651
2023-11-14,Region_4,0,203053,0,192900,0,4501,5651
2023-11-15,Region_4,0,203053,0,192900,0,4501,5651
2023-11-16,Region_4,0,203053,0,192900,0,4501,5651
2023-11-17,Region_4,0,203053,0,192900,0,4501,5651
2023-11-18,Region_4,0,203053,0,192900,0,4501,5651
2023-11-19,Region_4,0,203053,0,192900,0,4501,5651
2023-11-20,Region_4,0,203053,0,192900,0,4501,5651
2023-11-21,Region_4,0,203053,0,192900,0,4501,5651
2023-11-22,Region_4,0,203053,0,192900,0,4501,5651
2023-11-23,Region_4,0,203053,0,192900,0,4501,5651
2023-11-24,Region_4,0,203053,0,192900,0,4501,5651
2023-11-25,Region_4,0,203053,0,192900,0,4501,5651
2023-11-26,Region_4,0,203053,0,192900,0,4501,5651
2023-11-27,Region_4,0,203053,0,192900,0,4501,5651
2023-11-28,Region_4,0,203053,0,192900,0,4501,5651
2023-11-29,Region_4,0,203053,0,192900,0,4501,5651
2023-11-30,Region_4,0,203053,0,192900,0,4501,5651
2023-12-01,Region_4,0,203053,0,192900,0,4501,5651
2023-12-02,Region_4,0,203053,0,192900,0,4501,5651
2023-12-03,Region_4,0,203053,0,192900,0,4501,5651
2023-12-04,Region_4,0,203053,0,192900,0,4501,5651
2023-12-05,Region_4,0,203053,0,192900,0,4501,5651
2023-12-06,Region_4,0,203053,0,192900,0,4501,5651
2023-12-07,Region_4,0,203053,0,192900,0,4501,5651
2023-12-08,Region_4,0,203053,0,192900,0,4501,5651
2023-12-09,Region_4,0,203053,0,192900,0,4501,5651
2023-12-10,Region_4,0,203053,0,192900,0,4501,5651
2023-12-11,Region_4,0,203053,0,192900,0,4501,5651
2023-12-12,Region_4,0,203053,0,192900,0,4501,5651
2023-12-13,Region_4,0,203053,0,192900,0,4501,5651
2023-12-14,Region_4,0,203053,0,192900,0,4501,5651
2023-12-15,Region_4,0,203053,0,192900,0,4501,5651
2023-12-16,Region_4,0,203053,0,192900,0,4501,5651
2023-12-17,Region_4,0,203053,0,192900,0,4501,5651
2023-12-18,Region_4,0,203053,0,192900,0,4501,5651
2023-12-19,Region_4,0,203053,0,192900,0,4501,5651
2023-12-20,Region_4,0,203053,0,192900,0,4501,5651
2023-12-21,Region_4,0,203053,0,192900,0,4501,5651
2023-12-22,Region_4,0,203053,0,192900,0,4501,5651
2023-12-23,Region_4,0,203053,0,192900,0,4501,5651
2023-12-24,Region_4,0,203053,0,192900,0,4501,5651
2023-12-25,Region_4,0,203053,0,192900,0,4501,5651
2023-12-26,Region_4,0,203053,0,192900,0,4501,5651
2023-12-27,Region_4,0,203053,0,192900,0,4501,5651
2023-12-28,Region_4,0,203053,0,192900,0,4501,5651
2023-12-29,Region_4,0,203053,0,192900,0,4501,5651
2023-12-30,Region_4,0,203053,0,192900,0,4501,5651
2023-12-31,Region_4,0,203053,0,192900,0,4501,5651
2023-01-01,Region_5,0,0,0,0,0,0,0
2023-01-02,Region_5,0,0,0,0,0,0,0
2023-01-03,Region_5,0,0,0,0,0,0,0
2023-01-04,Region_5,0,0,0,0,0,0,0
2023-01-05,Region_5,0,0,0,0,0,0,0
2023-01-06,Region_5,0,0,0,0,0,0,0
2023-01-07,Region_5,0,0,0,0,0,0,0
2023-01-08,Region_5,0,0,0,0,0,0,0
2023-01-09,Region_5,0,0,0,0,0,0,0
2023-01-10,Region_5,0,0,0,0,0,0,0
2023-01-11,Region_5,0,0,0,0,0,0,0
2023-01-12,Region_5,0,0,0,0,0,0,0
2023-01-13,Region_5,0,0,0,0,0,0,0
2023-01-14,Region_5,0,0,0,0,0,0,0
2023-01-15,Region_5,0,0,0,0,0,0,0
2023-01-16,Region_5,0,0,0,0,0,0,0
2023-01-17,Region_5,0,0,0,0,0,0,0
2023-01-18,Region_5,0,0,0,0,0,0,0
2023-01-19,Region_5,0,0,0,0,0,0,0
2023-01-20,Region_5,0,0,0,0,0,0,0
2023-01-21,Region_5,0,0,0,0,0,0,0
2023-01-22,Region_5,0,0,0,0,0,0,0
2023-01-23,Region_5,0,0,0,0,0,0,0
2023-01-24,Region_5,0,0,0,0,0,0,0
2023-01-25,Region_5,0,0,0,0,0,0,0
2023-01-26,Region_5,0,0,0,0,0,0,0
2023-01-27,Region_5,0,0,0,0,0,0,0
2023-01-28,Region_5,4,4,0,0,0,0,4
2023-01-29,Region_5,3,7,0,0,0,0,7
2023-01-30,Region_5,5,12,0,0,0,0,12
2023-01-31,Region_5,5,17,0,0,0,0,17
2023-02-01,Region_5,5,22,0,0,0,0,22
2023-02-02,Region_5,13,35,0,0,0,0,35
2023-02-03,Region_5,22,57,0,0,0,0,57
2023-02-04,Region_5,20,77,0,0,0,0,77
2023-02-05,Region_5,37,114,0,0,0,0,114
2023-02-06,Region_5,64,178,0,0,0,0,178
2023-02-07,Region_5,75,253,0,0,0,0,253
2023-02-08,Region_5,132,385,0,0,0,0,385
2023-02-09,Region_5,220,605,3,3,0,0,601
2023-02-10,Region_5,309,914,2,6,0,0,907
2023-02-11,Region_5,465,1379,4,11,0,0,1367
2023-02-12,Region_5,666,2045,4,16,0,0,2028
2023-02-13,Region_5,1055,3100,4,20,0,0,3078
2023-02-14,Region_5,1585,4685,12,33,0,0,4651
2023-02-15,Region_5,2354,7039,20,54,0,0,6984
2023-02-16,Region_5,3613,10652,19,73,0,0,10577
2023-02-17,Region_5,5489,16141,35,108,0,1,16031
2023-02-18,Region_5,8129,24270,60,169,0,2,24098
2023-02-19,Region_5,11583,35853,71,240,0,3,35609
2023-02-20,Region_5,16095,51948,125,365,1,4,51577
2023-02-21,Region_5,21632,73580,209,574,2,7,72998
2023-02-22,Region_5,27515,101095,293,868,3,10,100215
2023-02-23,Region_5,32097,133192,441,1310,5,16,131865
2023-02-24,Region_5,33768,166960,632,1942,7,24,164992
2023-02-25,Region_5,30357,197317,1002,2945,12,36,194335
2023-02-26,Region_5,23977,221294,1505,4450,18,55,216787
2023-02-27,Region_5,15837,237131,2236,6687,27,83,230360
2023-02-28,Region_5,9163,246294,3432,10119,42,126,236048
2023-03-01,Region_5,4997,251291,5214,15333,65,191,235765
2023-03-02,Region_5,2505,253796,7722,23056,96,288,230451
2023-03-03,Region_5,1350,255146,11003,34060,137,425,220660
2023-03-04,Region_5,704,255850,15290,49350,190,616,205882
2023-03-05,Region_5,347,256197,20550,69901,256,873,185422
2023-03-06,Region_5,164,256361,26139,96040,326,1199,159121
2023-03-07,Region_5,95,256456,30492,126532,380,1580,128343
2023-03-08,Region_5,25,256481,32079,158612,400,1981,95887
2023-03-09,Region_5,0,256481,28839,187451,360,2341,66688
2023-03-10,Region_5,0,256481,22778,210229,284,2626,43625
2023-03-11,Region_5,0,256481,15045,225274,187,2813,28392
2023-03-12,Region_5,0,256481,8704,233979,108,2922,19579
2023-03-13,Region_5,0,256481,4747,238726,59,2981,14772
2023-03-14,Region_5,0,256481,2379,241106,29,3011,12363
2023-03-15,Region_5,0,256481,1282,242388,16,3027,11064
2023-03-16,Region_5,0,256481,668,243057,8,3036,10387
2023-03-17,Region_5,0,256481,329,243387,4,3040,10053
2023-03-18,Region_5,0,256481,155,243542,1,3042,9895
2023-03-19,Region_5,0,256481,90,243633,1,3043,9804
2023-03-20,Region_5,0,256481,23,243656,0,3043,9780
2023-03-21,Region_5,0,256481,0,243656,0,3043,9780
2023-03-22,Region_5,0,256481,0,243656,0,3043,9780
2023-03-23,Region_5,0,256481,0,243656,0,3043,9780
2023-03-24,Region_5,0,256481,0,243656,0,3043,9780
2023-03-25,Region_5,0,256481,0,243656,0,3043,9780
2023-03-26,Region_5,0,256481,0,243656,0,3043,9780
2023-03-27,Region_5,0,256481,0,243656,0,3043,9780
2023-03-28,Region_5,0,256481,0,243656,0,3043,9780
2023-03-29,Region_5,0,256481,0,243656,0,3043,9780
2023-03-30,Region_5,0,256481,0,243656,0,3043,9780
2023-03-31,Region_5,0,256481,0,243656,0,3043,9780
2023-04-01,Region_5,0,256481,0,243656,0,3043,9780
2023-04-02,Region_5,0,256481,0,243656,0,3043,9780
2023-04-03,Region_5,0,256481,0,243656,0,3043,9780
2023-04-04,Region_5,0,256481,0,243656,0,3043,9780
2023-04-05,Region_5,0,256481,0,243656,0,3043,9780
2023-04-06,Region_5,0,256481,0,243656,0,3043,9780
2023-04-07,Region_5,0,256481,0,243656,0,3043,9780
2023-04-08,Region_5,0,256481,0,243656,0,3043,9780
2023-04-09,Region_5,0,256481,0,243656,0,3043,9780
2023-04-10,Region_5,0,256481,0,243656,0,3043,9780
2023-04-11,Region_5,0,256481,0,243656,0,3043,9780
2023-04-12,Region_5,0,256481,0,243656,0,3043,9780
2023-04-13,Region_5,0,256481,0,243656,0,3043,9780
2023-04-14,Region_5,0,256481,0,243656,0,3043,9780
2023-04-15,Region_5,0,256481,0,243656,0,3043,9780
2023-04-16,Region_5,0,256481,0,243656,0,3043,9780
2023-04-17,Region_5,0,256481,0,243656,0,3043,9780
2023-04-18,Region_5,0,256481,0,243656,0,3043,9780
2023-04-19,Region_5,0,256481,0,243656,0,3043,9780
2023-04-20,Region_5,0,256481,0,243656,0,3043,9780
2023-04-21,Region_5,0,256481,0,243656,0,3043,9780
2023-04-22,Region_5,0,256481,0,243656,0,3043,9780
2023-04-23,Region_5,0,256481,0,243656,0,3043,9780
2023-04-24,Region_5,0,256481,0,243656,0,3043,9780
2023-04-25,Region_5,0,256481,0,243656,0,3043,9780
2023-04-26,Region_5,0,256481,0,243656,0,3043,9780
2023-04-27,Region_5,0,256481,0,243656,0,3043,9780
2023-04-28,Region_5,0,256481,0,243656,0,3043,9780
2023-04-29,Region_5,0,256481,0,243656,0,3043,9780
2023-04-30,Region_5,0,256481,0,243656,0,3043,9780
2023-05-01,Region_5,0,256481,0,243656,0,3043,9780
2023-05-02,Region_5,0,256481,0,243656,0,3043,9780
2023-05-03,Region_5,0,256481,0,243656,0,3043,9780
2023-05-04,Region_5,0,256481,0,243656,0,3043,9780
2023-05-05,Region_5,0,256481,0,243656,0,3043,9780
2023-05-06,Region_5,0,256481,0,243656,0,3043,9780
2023-05-07,Region_5,0,256481,0,243656,0,3043,9780
2023-05-08,Region_5,0,256481,0,243656,0,3043,9780
2023-05-09,Region_5,0,256481,0,243656,0,3043,9780
2023-05-10,Region_5,0,256481,0,243656,0,3043,9780
2023-05-11,Region_5,0,256481,0,243656,0,3043,9780
2023-05-12,Region_5,0,256481,0,243656,0,3043,9780
2023-05-13,Region_5,0,256481,0,243656,0,3043,9780
2023-05-14,Region_5,0,256481,0,243656,0,3043,9780
2023-05-15,Region_5,0,256481,0,243656,0,3043,9780
2023-05-16,Region_5,0,256481,0,243656,0,3043,9780
2023-05-17,Region_5,0,256481,0,243656,0,3043,9780
2023-05-18,Region_5,0,256481,0,243656,0,3043,9780
2023-05-19,Region_5,0,256481,0,243656,0,3043,9780
2023-05-20,Region_5,0,256481,0,243656,0,3043,9780
2023-05-21,Region_5,0,256481,0,243656,0,3043,9780
2023-05-22,Region_5,0,256481,0,243656,0,3043,9780
2023-05-23,Region_5,0,256481,0,243656,0,3043,9780
2023-05-24,Region_5,0,256481,0,243656,0,3043,9780
2023-05-25,Region_5,0,256481,0,243656,0,3043,9780
2023-05-26,Region_5,0,256481,0,243656,0,3043,9780
2023-05-27,Region_5,0,256481,0,243656,0,3043,9780
2023-05-28,Region_5,0,256481,0,243656,0,3043,9780
2023-05-29,Region_5,0,256481,0,243656,0,3043,9780
2023-05-30,Region_5,0,256481,0,243656,0,3043,9780
2023-05-31,Region_5,0,256481,0,243656,0,3043,9780
2023-06-01,Region_5,0,256481,0,243656,0,3043,9780
2023-06-02,Region_5,0,256481,0,243656,0,3043,9780
2023-06-03,Region_5,0,256481,0,243656,0,3043,9780
2023-06-04,Region_5,0,256481,0,243656,0,3043,9780
2023-06-05,Region_5,0,256481,0,243656,0,3043,9780
2023-06-06,Region_5,0,256481,0,243656,0,3043,9780
2023-06-07,Region_5,0,256481,0,243656,0,3043,9780
2023-06-08,Region_5,0,256481,0,243656,0,3043,9780
2023-06-09,Region_5,0,256481,0,243656,0,3043,9780
2023-06-10,Region_5,0,256481,0,243656,0,3043,9780
2023-06-11,Region_5,0,256481,0,243656,0,3043,9780
2023-06-12,Region_5,0,256481,0,243656,0,3043,9780
2023-06-13,Region_5,0,256481,0,243656,0,3043,9780
2023-06-14,Region_5,0,256481,0,243656,0,3043,9780
2023-06-15,Region_5,0,256481,0,243656,0,3043,9780
2023-06-16,Region_5,0,256481,0,243656,0,3043,9780
2023-06-17,Region_5,0,256481,0,243656,0,3043,9780
2023-06-18,Region_5,0,256481,0,243656,0,3043,9780
2023-06-19,Region_5,0,256481,0,243656,0,3043,9780
2023-06-20,Region_5,0,256481,0,243656,0,3043,9780
2023-06-21,Region_5,0,256481,0,243656,0,3043,9780
2023-06-22,Region_5,0,256481,0,243656,0,3043,9780
2023-06-23,Region_5,0,256481,0,243656,0,3043,9780
2023-06-24,Region_5,0,256481,0,243656,0,3043,9780
2023-06-25,Region_5,0,256481,0,243656,0,3043,9780
2023-06-26,Region_5,0,256481,0,243656,0,3043,9780
2023-06-27,Region_5,0,256481,0,243656,0,3043,9780
2023-06-28,Region_5,0,256481,0,243656,0,3043,9780
2023-06-29,Region_5,0,256481,0,243656,0,3043,9780
2023-06-30,Region_5,0,256481,0,243656,0,3043,9780
2023-07-01,Region_5,0,256481,0,243656,0,3043,9780
2023-07-02,Region_5,0,256481,0,243656,0,3043,9780
2023-07-03,Region_5,0,256481,0,243656,0,3043,9780
2023-07-04,Region_5,0,256481,0,243656,0,3043,9780
2023-07-05,Region_5,0,256481,0,243656,0,3043,9780
2023-07-06,Region_5,0,256481,0,243656,0,3043,9780
2023-07-07,Region_5,0,256481,0,243656,0,3043,9780
2023-07-08,Region_5,0,256481,0,243656,0,3043,9780
2023-07-09,Region_5,0,256481,0,243656,0,3043,9780
2023-07-10,Region_5,0,256481,0,243656,0,3043,9780
2023-07-11,Region_5,0,256481,0,243656,0,3043,9780
2023-07-12,Region_5,0,256481,0,243656,0,3043,9780
2023-07-13,Region_5,0,256481,0,243656,0,3043,9780
2023-07-14,Region_5,0,256481,0,243656,0,3043,9780
2023-07-15,Region_5,0,256481,0,243656,0,3043,9780
2023-07-16,Region_5,0,256481,0,243656,0,3043,9780
2023-07-17,Region_5,0,256481,0,243656,0,3043,9780
2023-07-18,Region_5,0,256481,0,243656,0,3043,9780
2023-07-19,Region_5,0,256481,0,243656,0,3043,9780
2023-07-20,Region_5,0,256481,0,243656,0,3043,9780
2023-07-21,Region_5,0,256481,0,243656,0,3043,9780
2023-07-22,Region_5,0,256481,0,243656,0,3043,9780
2023-07-23,Region_5,0,256481,0,243656,0,3043,9780
2023-07-24,Region_5,0,256481,0,243656,0,3043,9780
2023-07-25,Region_5,0,256481,0,243656,0,3043,9780
2023-07-26,Region_5,0,256481,0,243656,0,3043,9780
2023-07-27,Region_5,0,256481,0,243656,0,3043,9780
2023-07-28,Region_5,0,256481,0,243656,0,3043,9780
2023-07-29,Region_5,0,256481,0,243656,0,3043,9780
2023-07-30,Region_5,0,256481,0,243656,0,3043,9780
2023-07-31,Region_5,0,256481,0,243656,0,3043,9780
2023-08-01,Region_5,0,256481,0,243656,0,3043,9780
2023-08-02,Region_5,0,256481,0,243656,0,3043,9780
2023-08-03,Region_5,0,256481,0,243656,0,3043,9780
2023-08-04,Region_5,0,256481,0,243656,0,3043,9780
2023-08-05,Region_5,0,256481,0,243656,0,3043,9780
2023-08-06,Region_5,0,256481,0,243656,0,3043,9780
2023-08-07,Region_5,0,256481,0,243656,0,3043,9780
2023-08-08,Region_5,0,256481,0,243656,0,3043,9780
2023-08-09,Region_5,0,256481,0,243656,0,3043,9780
2023-08-10,Region_5,0,256481,0,243656,0,3043,9780
2023-08-11,Region_5,0,256481,0,243656,0,3043,9780
2023-08-12,Region_5,0,256481,0,243656,0,3043,9780
2023-08-13,Region_5,0,256481,0,243656,0,3043,9780
2023-08-14,Region_5,0,256481,0,243656,0,3043,9780
2023-08-15,Region_5,0,256481,0,243656,0,3043,9780
2023-08-16,Region_5,0,256481,0,243656,0,3043,9780
2023-08-17,Region_5,0,256481,0,243656,0,3043,9780
2023-08-18,Region_5,0,256481,0,243656,0,3043,9780
2023-08-19,Region_5,0,256481,0,243656,0,3043,9780
2023-08-20,Region_5,0,256481,0,243656,0,3043,9780
2023-08-21,Region_5,0,256481,0,243656,0,3043,9780
2023-08-22,Region_5,0,256481,0,243656,0,3043,9780
2023-08-23,Region_5,0,256481,0,243656,0,3043,9780
2023-08-24,Region_5,0,256481,0,243656,0,3043,9780
2023-08-25,Region_5,0,256481,0,243656,0,3043,9780
2023-08-26,Region_5,0,256481,0,243656,0,3043,9780
2023-08-27,Region_5,0,256481,0,243656,0,3043,9780
2023-08-28,Region_5,0,256481,0,243656,0,3043,9780
2023-08-29,Region_5,0,256481,0,243656,0,3043,9780
2023-08-30,Region_5,0,256481,0,243656,0,3043,9780
2023-08-31,Region_5,0,256481,0,243656,0,3043,9780
2023-09-01,Region_5,0,256481,0,243656,0,3043,9780
2023-09-02,Region_5,0,256481,0,243656,0,3043,9780
2023-09-03,Region_5,0,256481,0,243656,0,3043,9780
2023-09-04,Region_5,0,256481,0,243656,0,3043,9780
2023-09-05,Region_5,0,256481,0,243656,0,3043,9780
2023-09-06,Region_5,0,256481,0,243656,0,3043,9780
2023-09-07,Region_5,0,256481,0,243656,0,3043,9780
2023-09-08,Region_5,0,256481,0,243656,0,3043,9780
2023-09-09,Region_5,0,256481,0,243656,0,3043,9780
2023-09-10,Region_5,0,256481,0,243656,0,3043,9780
2023-09-11,Region_5,0,256481,0,243656,0,3043,9780
2023-09-12,Region_5,0,256481,0,243656,0,3043,9780
2023-09-13,Region_5,0,256481,0,243656,0,3043,9780
2023-09-14,Region_5,0,256481,0,243656,0,3043,9780
2023-09-15,Region_5,0,256481,0,243656,0,3043,9780
2023-09-16,Region_5,0,256481,0,243656,0,3043,9780
2023-09-17,Region_5,0,256481,0,243656,0,3043,9780
2023-09-18,Region_5,0,256481,0,243656,0,3043,9780
2023-09-19,Region_5,0,256481,0,243656,0,3043,9780
2023-09-20,Region_5,0,256481,0,243656,0,3043,9780
2023-09-21,Region_5,0,256481,0,243656,0,3043,9780
2023-09-22,Region_5,0,256481,0,243656,0,3043,9780
2023-09-23,Region_5,0,256481,0,243656,0,3043,9780
2023-09-24,Region_5,0,256481,0,243656,0,3043,9780
2023-09-25,Region_5,0,256481,0,243656,0,3043,9780
2023-09-26,Region_5,0,256481,0,243656,0,3043,9780
2023-09-27,Region_5,0,256481,0,243656,0,3043,9780
2023-09-28,Region_5,0,256481,0,243656,0,3043,9780
2023-09-29,Region_5,0,256481,0,243656,0,3043,9780
2023-09-30,Region_5,0,256481,0,243656,0,3043,9780
2023-10-01,Region_5,0,256481,0,243656,0,3043,9780
2023-10-02,Region_5,0,256481,0,243656,0,3043,9780
2023-10-03,Region_5,0,256481,0,243656,0,3043,9780
2023-10-04,Region_5,0,256481,0,243656,0,3043,9780
2023-10-05,Region_5,0,256481,0,243656,0,3043,9780
2023-10-06,Region_5,0,256481,0,243656,0,3043,9780
2023-10-07,Region_5,0,256481,0,243656,0,3043,9780
2023-10-08,Region_5,0,256481,0,243656,0,3043,9780
2023-10-09,Region_5,0,256481,0,243656,0,3043,9780
2023-10-10,Region_5,0,256481,0,243656,0,3043,9780
2023-10-11,Region_5,0,256481,0,243656,0,3043,9780
2023-10-12,Region_5,0,256481,0,243656,0,3043,9780
2023-10-13,Region_5,0,256481,0,243656,0,3043,9780
2023-10-14,Region_5,0,256481,0,243656,0,3043,9780
2023-10-15,Region_5,0,256481,0,243656,0,3043,9780
2023-10-16,Region_5,0,256481,0,243656,0,3043,9780
2023-10-17,Region_5,0,256481,0,243656,0,3043,9780
2023-10-18,Region_5,0,256481,0,243656,0,3043,9780
2023-10-19,Region_5,0,256481,0,243656,0,3043,9780
2023-10-20,Region_5,0,256481,0,243656,0,3043,9780
2023-10-21,Region_5,0,256481,0,243656,0,3043,9780
2023-10-22,Region_5,0,256481,0,243656,0,3043,9780
2023-10-23,Region_5,0,256481,0,243656,0,3043,9780
2023-10-24,Region_5,0,256481,0,243656,0,3043,9780
2023-10-25,Region_5,0,256481,0,243656,0,3043,9780
2023-10-26,Region_5,0,256481,0,243656,0,3043,9780
2023-10-27,Region_5,0,256481,0,243656,0,3043,9780
2023-10-28,Region_5,0,256481,0,243656,0,3043,9780
2023-10-29,Region_5,0,256481,0,243656,0,3043,9780
2023-10-30,Region_5,0,256481,0,243656,0,3043,9780
2023-10-31,Region_5,0,256481,0,243656,0,3043,9780
2023-11-01,Region_5,0,256481,0,243656,0,3043,9780
2023-11-02,Region_5,0,256481,0,243656,0,3043,9780
2023-11-03,Region_5,0,256481,0,243656,0,3043,9780
2023-11-04,Region_5,0,256481,0,243656,0,3043,9780
2023-11-05,Region_5,0,256481,0,243656,0,3043,9780
2023-11-06,Region_5,0,256481,0,243656,0,3043,9780
2023-11-07,Region_5,0,256481,0,243656,0,3043,9780
2023-11-08,Region_5,0,256481,0,243656,0,3043,9780
2023-11-09,Region_5,0,256481,0,243656,0,3043,9780
2023-11-10,Region_5,0,256481,0,243656,0,3043,9780
2023-11-11,Region_5,0,256481,0,243656,0,3043,9780
2023-11-12,Region_5,0,256481,0,243656,0,3043,9780
2023-11-13,Region_5,0,256481,0,243656,0,3043,9780
2023-11-14,Region_5,0,256481,0,243656,0,3043,9780
2023-11-15,Region_5,0,256481,0,243656,0,3043,9780
2023-11-16,Region_5,0,256481,0,243656,0,3043,9780
2023-11-17,Region_5,0,256481,0,243656,0,3043,9780
2023-11-18,Region_5,0,256481,0,243656,0,3043,9780
2023-11-19,Region_5,0,256481,0,243656,0,3043,9780
2023-11-20,Region_5,0,256481,0,243656,0,3043,9780
2023-11-21,Region_5,0,256481,0,243656,0,3043,9780
2023-11-22,Region_5,0,256481,0,243656,0,3043,9780
2023-11-23,Region_5,0,256481,0,243656,0,3043,9780
2023-11-24,Region_5,0,256481,0,243656,0,3043,9780
2023-11-25,Region_5,0,256481,0,243656,0,3043,9780
2023-11-26,Region_5,0,256481,0,243656,0,3043,9780
2023-11-27,Region_5,0,256481,0,243656,0,3043,9780
2023-11-28,Region_5,0,256481,0,243656,0,3043,9780
2023-11-29,Region_5,0,256481,0,243656,0,3043,9780
2023-11-30,Region_5,0,256481,0,243656,0,3043,9780
2023-12-01,Region_5,0,256481,0,243656,0,3043,9780
2023-12-02,Region_5,0,256481,0,243656,0,3043,9780
2023-12-03,Region_5,0,256481,0,243656,0,3043,9780
2023-12-04,Region_5,0,256481,0,243656,0,3043,9780
2023-12-05,Region_5,0,256481,0,243656,0,3043,9780
2023-12-06,Region_5,0,256481,0,243656,0,3043,9780
2023-12-07,Region_5,0,256481,0,243656,0,3043,9780
2023-12-08,Region_5,0,256481,0,243656,0,3043,9780
2023-12-09,Region_5,0,256481,0,243656,0,3043,9780
2023-12-10,Region_5,0,256481,0,243656,0,3043,9780
2023-12-11,Region_5,0,256481,0,243656,0,3043,9780
2023-12-12,Region_5,0,256481,0,243656,0,3043,9780
2023-12-13,Region_5,0,256481,0,243656,0,3043,9780
2023-12-14,Region_5,0,256481,0,243656,0,3043,9780
2023-12-15,Region_5,0,256481,0,243656,0,3043,9780
2023-12-16,Region_5,0,256481,0,243656,0,3043,9780
2023-12-17,Region_5,0,256481,0,243656,0,3043,9780
2023-12-18,Region_5,0,256481,0,243656,0,3043,9780
2023-12-19,Region_5,0,256481,0,243656,0,3043,9780
2023-12-20,Region_5,0,256481,0,243656,0,3043,9780
2023-12-21,Region_5,0,256481,0,243656,0,3043,9780
2023-12-22,Region_5,0,256481,0,243656,0,3043,9780
2023-12-23,Region_5,0,256481,0,243656,0,3043,9780
2023-12-24,Region_5,0,256481,0,243656,0,3043,9780
2023-12-25,Region_5,0,256481,0,243656,0,3043,9780
2023-12-26,Region_5,0,256481,0,243656,0,3043,9780
2023-12-27,Region_5,0,256481,0,243656,0,3043,9780
2023-12-28,Region_5,0,256481,0,243656,0,3043,9780
2023-12-29,Region_5,0,256481,0,243656,0,3043,9780
2023-12-30,Region_5,0,256481,0,243656,0,3043,9780
2023-12-31,Region_5,0,256481,0,243656,0,3043,9780
